Filename,Src tree size,Dest tree size,Src tree height,Dest tree height,EditScript size,Average Diffing time (ms),Nodes/ms,Tree size,raw data (ns)
keras-1-7b76bed7/setup.py,107,107,11,11,2,0.4793,446,214,479300
keras-2-9a2b5092/setup.py,107,108,11,11,7,0.8725,246,215,872500
keras-3-fb8fef25/setup.py,108,110,11,11,10,0.8695,250,218,869500
keras-7-7a39b6c6/activations.py,74,697,6,20,819,5.4026,142,771,5402600
keras-7-7a39b6c6/activations_test.py,2637,2680,16,16,52,14.6349,363,5317,14634900
keras-7-7a39b6c6/advanced_activations.py,34,2111,6,18,2465,13.7234,156,2145,13723400
keras-7-7a39b6c6/advanced_activations_test.py,476,665,13,13,217,4.0886,279,1141,4088600
keras-7-7a39b6c6/base_layer.py,14,8331,6,32,9841,54.7053,152,8345,54705300
keras-7-7a39b6c6/boston_housing.py,9,405,6,16,467,2.7058,153,414,2705800
keras-7-7a39b6c6/callbacks.py,7,8064,6,26,9609,50.2693,160,8071,50269300
keras-7-7a39b6c6/callbacks_test.py,9219,9204,21,21,56,52.1415,353,18423,52141500
keras-7-7a39b6c6/cifar10.py,9,424,6,18,511,2.8834,150,433,2883400
keras-7-7a39b6c6/cifar100.py,9,348,6,13,424,2.2551,158,357,2255100
keras-7-7a39b6c6/conftest.py,6,6,6,6,1,0.0533,225,12,53300
keras-7-7a39b6c6/constraints.py,115,970,6,18,1068,6.9376,156,1085,6937600
keras-7-7a39b6c6/convolutional.py,189,11986,6,23,14263,75.2917,161,12175,75291700
keras-7-7a39b6c6/convolutional_recurrent.py,9,7956,6,28,9393,50.2378,158,7965,50237800
keras-7-7a39b6c6/convolutional_recurrent_test.py,1511,1511,16,16,1,6.0605,498,3022,6060500
keras-7-7a39b6c6/convolutional_test.py,9881,10325,20,20,813,78.7275,256,20206,78727500
keras-7-7a39b6c6/conv_utils.py,1056,1109,21,21,78,7.0868,305,2165,7086800
keras-7-7a39b6c6/conv_utils_test.py,1000,1032,14,14,42,5.8601,346,2032,5860100
keras-7-7a39b6c6/core.py,69,5928,6,21,7001,37.3797,160,5997,37379700
keras-7-7a39b6c6/core_test.py,3310,3540,18,18,302,24.659,277,6850,24659000
keras-7-7a39b6c6/cudnn_recurrent.py,16,4776,6,23,5585,27.8364,172,4792,27836400
keras-7-7a39b6c6/datasets_test.py,971,971,13,13,3,3.8168,508,1942,3816800
keras-7-7a39b6c6/data_utils.py,29,3980,6,23,4716,24.5085,163,4009,24508500
keras-7-7a39b6c6/data_utils_test.py,5444,5521,18,18,113,32.0475,342,10965,32047500
keras-7-7a39b6c6/densenet.py,27,166,6,9,161,1.2381,155,193,1238100
keras-7-7a39b6c6/embeddings.py,9,1019,6,25,1207,6.117,168,1028,6117000
keras-7-7a39b6c6/embeddings_test.py,329,329,16,16,1,1.2982,506,658,1298200
keras-7-7a39b6c6/fashion_mnist.py,9,406,6,15,474,2.4664,168,415,2466400
keras-7-7a39b6c6/generic_utils.py,1090,4203,21,25,3478,30.3507,174,5293,30350700
keras-7-7a39b6c6/generic_utils_test.py,738,1220,16,16,580,9.8013,199,1958,9801300
keras-7-7a39b6c6/image.py,9,2196,6,13,2715,11.9031,185,2205,11903100
keras-7-7a39b6c6/imagenet_utils.py,14,84,6,9,82,0.6304,155,98,630400
keras-7-7a39b6c6/imdb.py,14,932,6,17,1100,5.7827,163,946,5782700
keras-7-7a39b6c6/inception_resnet_v2.py,17,110,6,9,107,0.8242,154,127,824200
keras-7-7a39b6c6/inception_v3.py,17,110,6,9,107,0.7658,165,127,765800
keras-7-7a39b6c6/initializers.py,9,2675,6,19,3223,16.0323,167,2684,16032300
keras-7-7a39b6c6/input_layer.py,14,903,6,18,1081,5.3157,172,917,5315700
keras-7-7a39b6c6/io_utils.py,9,3514,6,23,4128,20.7452,169,3523,20745200
keras-7-7a39b6c6/layer_utils.py,573,185,17,15,445,4.6865,161,758,4686500
keras-7-7a39b6c6/layer_utils_test.py,742,742,18,18,1,2.9424,504,1484,2942400
keras-7-7a39b6c6/local.py,14,2792,6,17,3298,15.355,182,2806,15355000
keras-7-7a39b6c6/losses.py,9,3830,6,16,4522,22.3859,171,3839,22385900
keras-7-7a39b6c6/losses_test.py,10671,10918,21,21,386,73.0057,295,21589,73005700
keras-7-7a39b6c6/merge.py,84,5086,6,26,6014,32.1831,160,5170,32183100
keras-7-7a39b6c6/merge_test.py,4779,4687,19,19,159,29.5378,320,9466,29537800
keras-7-7a39b6c6/metrics.py,9,9996,6,19,11833,58.9917,169,10005,58991700
keras-7-7a39b6c6/metrics_confusion_matrix_test.py,12485,12485,19,19,2,46.5239,536,24970,46523900
keras-7-7a39b6c6/metrics_correctness_test.py,3841,3841,17,17,5,14.5431,528,7682,14543100
keras-7-7a39b6c6/metrics_functional_test.py,1420,1432,17,17,12,7.4588,382,2852,7458800
keras-7-7a39b6c6/metrics_training_test.py,932,891,15,15,63,6.2285,292,1823,6228500
keras-7-7a39b6c6/mnist.py,9,162,6,12,190,1.0362,165,171,1036200
keras-7-7a39b6c6/mobilenet.py,17,110,6,9,107,0.7443,170,127,744300
keras-7-7a39b6c6/mobilenet_v2.py,17,110,6,9,107,0.7214,176,127,721400
keras-7-7a39b6c6/models.py,54,1812,6,21,2088,10.7303,173,1866,10730300
keras-7-7a39b6c6/multi_gpu_utils.py,9,1243,6,23,1457,7.5638,165,1252,7563800
keras-7-7a39b6c6/nasnet.py,22,138,6,9,133,0.8907,179,160,890700
keras-7-7a39b6c6/network.py,15,10795,6,30,12659,63.9807,168,10810,63980700
keras-7-7a39b6c6/noise.py,19,1147,6,19,1331,6.6365,175,1166,6636500
keras-7-7a39b6c6/normalization.py,9,1732,6,20,2038,9.4147,184,1741,9414700
keras-7-7a39b6c6/normalization_test.py,807,807,14,14,0,3.2009,504,1614,3200900
keras-7-7a39b6c6/np_utils.py,14,375,6,14,437,2.1857,177,389,2185700
keras-7-7a39b6c6/optimizers_test.py,2009,1967,18,18,84,12.152,327,3976,12152000
keras-7-7a39b6c6/pooling.py,160,4408,6,16,5203,25.04,182,4568,25040000
keras-7-7a39b6c6/pooling_test.py,1147,1171,14,14,116,7.8138,296,2318,7813800
keras-7-7a39b6c6/recurrent.py,44,17518,6,28,20690,98.419,178,17562,98419000
keras-7-7a39b6c6/recurrent_test.py,9872,9964,18,18,151,68.8177,288,19836,68817700
keras-7-7a39b6c6/regularizers.py,9,583,6,18,685,5.5707,106,592,5570700
keras-7-7a39b6c6/regularizers_test.py,1066,1094,14,14,52,8.0818,267,2160,8081800
keras-7-7a39b6c6/resnet.py,27,180,6,10,180,1.3638,151,207,1363800
keras-7-7a39b6c6/resnet50.py,17,110,6,9,107,0.7564,167,127,756400
keras-7-7a39b6c6/resnet_v2.py,27,180,6,10,180,1.245,166,207,1245000
keras-7-7a39b6c6/reuters.py,14,782,6,16,923,4.8011,165,796,4801100
keras-7-7a39b6c6/saving.py,29,9824,6,30,11636,62.4065,157,9853,62406500
keras-7-7a39b6c6/scikit_learn.py,9,1884,6,19,2219,9.9611,190,1893,9961100
keras-7-7a39b6c6/scikit_learn_test.py,1792,1792,14,14,2,6.9657,514,3584,6965700
keras-7-7a39b6c6/sequence.py,9,92,6,7,98,0.5244,192,101,524400
keras-7-7a39b6c6/sequence_test.py,3011,3117,20,20,149,21.5978,283,6128,21597800
keras-7-7a39b6c6/sequential.py,9,1633,6,20,1926,8.9224,184,1642,8922400
keras-7-7a39b6c6/setup.py,110,112,11,11,6,0.7677,289,222,767700
keras-7-7a39b6c6/tensorboard_test.py,2682,2682,15,15,1,10.5327,509,5364,10532700
keras-7-7a39b6c6/test_image_data_tasks.py,755,755,15,15,3,2.9758,507,1510,2975800
keras-7-7a39b6c6/test_loss_masking.py,372,570,14,14,239,4.5842,205,942,4584200
keras-7-7a39b6c6/test_model_saving.py,7563,11090,17,18,4473,88.2786,211,18653,88278600
keras-7-7a39b6c6/test_sequential_model.py,5649,5796,20,20,276,42.9861,266,11445,42986100
keras-7-7a39b6c6/test_temporal_data_tasks.py,1919,1919,19,19,3,7.3117,524,3838,7311700
keras-7-7a39b6c6/test_topology.py,10100,10872,18,18,1352,90.7272,231,20972,90727200
keras-7-7a39b6c6/test_training.py,22363,23286,20,20,1366,139.4717,327,45649,139471700
keras-7-7a39b6c6/test_utils.py,1187,2462,16,20,1501,15.1993,240,3649,15199300
keras-7-7a39b6c6/text.py,9,79,6,6,81,0.399,220,88,399000
keras-7-7a39b6c6/topology.py,25,27,6,6,3,0.2216,234,52,221600
keras-7-7a39b6c6/training.py,9,9779,6,28,11580,46.4481,210,9788,46448100
keras-7-7a39b6c6/variational_autoencoder.py,1789,1813,18,18,46,11.2031,321,3602,11203100
keras-7-7a39b6c6/vgg16.py,17,110,6,9,107,0.5784,219,127,578400
keras-7-7a39b6c6/vgg19.py,17,110,6,9,107,0.5848,217,127,584800
keras-7-7a39b6c6/vis_utils.py,14,1914,6,31,2256,9.2272,208,1928,9227200
keras-7-7a39b6c6/wrappers.py,19,5846,6,23,6870,28.3669,206,5865,28366900
keras-7-7a39b6c6/wrappers_test.py,5838,6039,20,20,242,32.1124,369,11877,32112400
keras-7-7a39b6c6/xception.py,17,110,6,9,107,0.5878,216,127,587800
keras-7-7a39b6c6/__init__.py,74,7,6,6,69,0.3508,230,81,350800
keras-8-e8946d52/lstm_seq2seq.py,1791,1788,18,18,3,8.0461,444,3579,8046100
keras-8-e8946d52/lstm_seq2seq_restore.py,1374,1371,16,16,3,6.2216,441,2745,6221600
keras-9-ecac367b/np_utils.py,375,375,14,14,1,1.3128,571,750,1312800
keras-10-4d59675b/metrics_training_test.py,891,902,15,15,16,3.9682,451,1793,3968200
keras-10-4d59675b/saving.py,9824,9803,30,30,23,44.2004,444,19627,44200400
keras-10-4d59675b/test_model_saving.py,11090,10940,18,18,152,72.5349,303,22030,72534900
keras-11-afff7b43/core.py,5928,5928,21,21,3,18.9714,624,11856,18971400
keras-12-e25f68dc/pooling.py,4408,4408,16,16,12,13.7673,640,8816,13767300
keras-13-f242c642/io_utils.py,3514,3514,23,23,1,11.7284,599,7028,11728400
keras-14-2b1f8ed2/autogen.py,4913,4876,21,21,37,22.1462,442,9789,22146200
keras-15-97e3916d/training.py,9779,9779,28,28,4,32.1721,607,19558,32172100
keras-17-c8f66d15/conv_utils.py,1109,1187,21,26,228,6.866,334,2296,6866000
keras-17-c8f66d15/data_utils.py,3980,3996,23,23,42,21.5961,369,7976,21596100
keras-17-c8f66d15/generic_utils.py,4203,4208,25,25,170,24.7698,339,8411,24769800
keras-17-c8f66d15/multi_gpu_utils.py,1243,1243,23,23,2,5.9157,420,2486,5915700
keras-17-c8f66d15/vis_utils.py,1914,1914,31,31,2,9.2891,412,3828,9289100
keras-18-f295e8ee/convolutional_recurrent.py,7956,7956,28,28,1,25.55,622,15912,25550000
keras-19-8904340b/setup.py,112,112,11,11,1,0.3986,561,224,398600
keras-20-481e99d6/training.py,9779,9779,28,28,2,32.278,605,19558,32278000
keras-21-16bd239e/recurrent.py,17518,17518,28,28,4,54.709,640,35036,54709000
keras-22-f0464c94/callbacks.py,8064,8014,26,26,50,36.6527,438,16078,36652700
keras-23-985521ee/vis_utils.py,1914,1903,31,31,13,8.4912,449,3817,8491200
keras-24-5be4ed3d/local.py,2792,2792,17,17,2,8.7415,638,5584,8741500
keras-25-f2bbf98b/saving.py,9803,9773,30,30,34,43.5114,449,19576,43511400
keras-26-9ad5a18f/normalization.py,1732,1734,20,20,2,7.4853,463,3466,7485300
keras-26-9ad5a18f/recurrent.py,17518,17495,28,28,40,74.3344,471,35013,74334400
keras-26-9ad5a18f/wrappers.py,5846,5820,23,23,35,26.9117,433,11666,26911700
keras-27-04cbccc8/autogen.py,4876,4858,21,21,28,23.5958,412,9734,23595800
keras-28-4f94a15e/training_utils.py,7203,7203,26,26,1,24.8295,580,14406,24829500
keras-29-95fab0e0/data_utils.py,3996,3996,23,23,1,12.9352,617,7992,12935200
keras-31-8a8ef43f/base_layer.py,8331,8305,32,32,28,36.9998,449,16636,36999800
keras-34-cf9595ae/optimizers.py,9700,9663,22,22,46,43.014,450,19363,43014000
keras-34-cf9595ae/tensorflow_backend.py,12181,12069,22,22,182,67.2537,360,24250,67253700
keras-35-78691340/data_utils.py,3996,3993,23,23,13,18.3114,436,7989,18311400
keras-35-78691340/data_utils_test.py,5521,5045,18,16,484,32.5443,324,10566,32544300
keras-37-71838135/callbacks.py,8014,8014,26,26,2,25.8103,620,16028,25810300
keras-39-93b0f1ca/imagenet_utils_test.py,1720,1720,15,15,1,5.5384,621,3440,5538400
keras-41-1eac8612/backend_test.py,26136,25688,23,23,450,110.6676,468,51824,110667600
keras-41-1eac8612/numpy_backend.py,8983,8918,24,24,67,38.9413,459,17901,38941300
keras-41-1eac8612/tensorflow_backend.py,12069,12069,22,22,1,38.9814,619,24138,38981400
keras-42-ccecd39d/base_layer.py,8305,8305,32,32,1,27.2839,608,16610,27283900
keras-43-280e5b72/convolutional.py,11986,11986,23,23,1,38.2495,626,23972,38249500
keras-44-66455371/base_layer.py,8305,8305,32,32,1,27.8321,596,16610,27832100
keras-45-8315a0b7/babi_rnn.py,1686,1686,18,18,1,5.8922,572,3372,5892200
keras-46-3e8e2733/lstm_seq2seq.py,1788,1698,18,18,92,8.6452,403,3486,8645200
keras-47-88ca804d/losses.py,3830,3812,16,16,21,16.9641,450,7642,16964100
keras-48-1cf5218e/multi_gpu_utils.py,1243,1237,23,23,30,6.0626,409,2480,6062600
keras-49-a8478c3a/data_utils.py,3993,3934,23,23,80,20.045,395,7927,20045000
keras-49-a8478c3a/data_utils_test.py,5045,4588,16,16,461,27.2659,353,9633,27265900
keras-49-a8478c3a/image.py,2196,2190,13,13,12,9.8189,446,4386,9818900
keras-49-a8478c3a/tensorflow_backend.py,12069,12027,22,22,64,57.1914,421,24096,57191400
keras-49-a8478c3a/test_training.py,23286,21807,20,20,1500,114.8693,392,45093,114869300
keras-49-a8478c3a/training_generator.py,4211,4089,26,26,139,19.1148,434,8300,19114800
keras-51-da289bb3/metrics_confusion_matrix_test.py,12485,12491,19,19,8,52.5941,474,24976,52594100
keras-52-3e70caf7/metrics_confusion_matrix_test.py,12491,12485,19,19,8,53.0199,471,24976,53019900
keras-53-b86a986c/metrics_training_test.py,902,871,15,15,33,3.8703,458,1773,3870300
keras-54-fe4110f2/metrics_confusion_matrix_test.py,12485,12473,19,19,16,52.7606,473,24958,52760600
keras-55-a1be7c3e/metrics.py,9996,10131,19,19,150,46.9218,428,20127,46921800
keras-55-a1be7c3e/metrics_confusion_matrix_test.py,12473,12533,19,19,66,53.1484,470,25006,53148400
keras-55-a1be7c3e/metrics_training_test.py,871,847,15,15,26,3.7171,462,1718,3717100
keras-56-922dd779/metrics.py,10131,9996,19,19,135,47.674,422,20127,47674000
keras-56-922dd779/metrics_confusion_matrix_test.py,12533,12473,19,19,60,53.4347,467,25006,53434700
keras-56-922dd779/metrics_training_test.py,847,850,15,15,3,3.8216,444,1697,3821600
keras-58-bb9293cb/metrics_confusion_matrix_test.py,12473,12699,19,19,367,64.9653,387,25172,64965300
keras-58-bb9293cb/metrics_training_test.py,850,766,15,17,370,5.934,272,1616,5934000
keras-58-bb9293cb/metrics_utils.py,2061,2040,18,18,55,10.1035,405,4101,10103500
keras-58-bb9293cb/test_image_data_tasks.py,755,755,15,15,1,2.3716,636,1510,2371600
keras-58-bb9293cb/theano_backend.py,24714,24661,24,24,62,106.1638,465,49375,106163800
keras-59-69fcefd8/base_layer.py,8305,8293,32,32,12,36.5829,453,16598,36582900
keras-59-69fcefd8/cifar10_cnn.py,1027,1027,12,12,2,3.1854,644,2054,3185400
keras-59-69fcefd8/cifar10_resnet.py,458,458,12,12,0,1.5007,610,916,1500700
keras-59-69fcefd8/class_activation_maps.py,2,2,2,2,0,0.0268,149,4,26800
keras-59-69fcefd8/conv_filter_visualization.py,1779,1772,20,20,13,7.8923,449,3551,7892300
keras-59-69fcefd8/deep_dream.py,1603,1593,19,18,15,7.4308,430,3196,7430800
keras-59-69fcefd8/image_ocr.py,5880,5883,22,22,5,25.1092,468,11763,25109200
keras-59-69fcefd8/losses_utils.py,1285,1245,21,21,42,5.6103,450,2530,5610300
keras-59-69fcefd8/lstm_text_generation.py,1153,1153,20,20,1,3.6775,627,2306,3677500
keras-59-69fcefd8/mnist_acgan.py,3024,3024,22,22,2,9.3154,649,6048,9315400
keras-59-69fcefd8/mnist_irnn.py,536,536,12,12,1,1.6768,639,1072,1676800
keras-59-69fcefd8/mnist_net2net.py,187,187,13,13,0,0.6345,589,374,634500
keras-59-69fcefd8/mnist_sklearn_wrapper.py,862,862,13,13,0,2.6707,645,1724,2670700
keras-59-69fcefd8/mnist_swwae.py,4,4,4,4,0,0.0346,231,8,34600
keras-59-69fcefd8/neural_doodle.py,4,4,4,4,0,0.0436,183,8,43600
keras-59-69fcefd8/neural_style_transfer.py,2394,2379,17,17,26,10.6547,447,4773,10654700
keras-59-69fcefd8/tensorboard_v2.py,281,277,13,13,6,1.2785,436,558,1278500
keras-59-69fcefd8/tensorflow_backend.py,12027,12003,22,22,25,51.2633,468,24030,51263300
keras-59-69fcefd8/training_generator.py,4089,4079,26,26,28,17.9983,453,8168,17998300
keras-59-69fcefd8/training_utils.py,7203,7203,26,26,1,23.071,624,14406,23071000
keras-60-763f69fb/base_layer.py,8293,8305,32,32,12,34.9273,475,16598,34927300
keras-60-763f69fb/cifar10_cnn.py,1027,1027,12,12,2,3.1706,647,2054,3170600
keras-60-763f69fb/cifar10_resnet.py,458,458,12,12,0,1.4743,621,916,1474300
keras-60-763f69fb/class_activation_maps.py,2,2,2,2,0,0.0254,157,4,25400
keras-60-763f69fb/conv_filter_visualization.py,1772,1779,20,20,14,8.0056,443,3551,8005600
keras-60-763f69fb/deep_dream.py,1593,1603,18,19,16,7.4381,429,3196,7438100
keras-60-763f69fb/image_ocr.py,5883,5880,22,22,5,25.89,454,11763,25890000
keras-60-763f69fb/losses_utils.py,1245,1285,21,21,52,5.7978,436,2530,5797800
keras-60-763f69fb/lstm_text_generation.py,1153,1153,20,20,1,3.6861,625,2306,3686100
keras-60-763f69fb/metrics.py,9996,8374,19,19,1715,64.9646,282,18370,64964600
keras-60-763f69fb/metrics_confusion_matrix_test.py,12699,6705,19,16,5994,47.0575,412,19404,47057500
keras-60-763f69fb/metrics_utils.py,2040,1913,18,18,162,11.1943,353,3953,11194300
keras-60-763f69fb/mnist_acgan.py,3024,3024,22,22,2,10.1162,597,6048,10116200
keras-60-763f69fb/mnist_irnn.py,536,536,12,12,1,1.9903,538,1072,1990300
keras-60-763f69fb/mnist_net2net.py,187,187,13,13,0,0.6978,535,374,697800
keras-60-763f69fb/mnist_sklearn_wrapper.py,862,862,13,13,0,2.7231,633,1724,2723100
keras-60-763f69fb/mnist_swwae.py,4,4,4,4,0,0.0345,231,8,34500
keras-60-763f69fb/neural_doodle.py,4,4,4,4,0,0.0343,233,8,34300
keras-60-763f69fb/neural_style_transfer.py,2379,2394,17,17,28,10.8477,440,4773,10847700
keras-60-763f69fb/tensorboard_v2.py,277,281,13,13,7,1.2507,446,558,1250700
keras-60-763f69fb/tensorflow_backend.py,12003,12027,22,22,26,50.4044,476,24030,50404400
keras-60-763f69fb/training_generator.py,4079,4089,26,26,30,18.2436,447,8168,18243600
keras-60-763f69fb/training_utils.py,7203,7203,26,26,1,23.1218,623,14406,23121800
keras-61-6bb3fb7c/image_ocr.py,5880,5880,22,22,1,19.1587,613,11760,19158700
keras-61-6bb3fb7c/mnist_swwae.py,4,4,4,4,0,0.0348,229,8,34800
keras-61-6bb3fb7c/neural_doodle.py,4,4,4,4,0,0.0336,238,8,33600
keras-61-6bb3fb7c/neural_style_transfer.py,2394,2379,17,17,26,10.7625,443,4773,10762500
keras-61-6bb3fb7c/tensorflow_backend.py,12027,12003,22,22,25,51.7138,464,24030,51713800
keras-62-e6d685b1/base_layer.py,8305,8293,32,32,12,34.8854,475,16598,34885400
keras-62-e6d685b1/losses_utils.py,1285,1245,21,21,42,5.7487,440,2530,5748700
keras-62-e6d685b1/tensorboard_v2.py,281,277,13,13,6,1.2122,460,558,1212200
keras-62-e6d685b1/training_utils.py,7203,7203,26,26,1,23.2206,620,14406,23220600
keras-63-d8446ef6/cifar10_cnn.py,1027,1027,12,12,1,3.3016,622,2054,3301600
keras-63-d8446ef6/cifar10_resnet.py,458,458,12,12,0,1.4587,627,916,1458700
keras-63-d8446ef6/class_activation_maps.py,2,2,2,2,0,0.0236,169,4,23600
keras-63-d8446ef6/deep_dream.py,1603,1593,19,18,15,7.5588,422,3196,7558800
keras-63-d8446ef6/image_ocr.py,5880,5883,22,22,4,25.3714,463,11763,25371400
keras-63-d8446ef6/lstm_text_generation.py,1153,1153,20,20,1,3.8181,603,2306,3818100
keras-63-d8446ef6/mnist_acgan.py,3024,3024,22,22,2,9.6104,629,6048,9610400
keras-63-d8446ef6/mnist_irnn.py,536,536,12,12,1,1.7051,628,1072,1705100
keras-63-d8446ef6/mnist_net2net.py,187,187,13,13,0,0.6245,598,374,624500
keras-63-d8446ef6/mnist_sklearn_wrapper.py,862,862,13,13,0,2.692,640,1724,2692000
keras-64-2bc43bff/conv_filter_visualization.py,1779,1772,20,20,13,8.197,433,3551,8197000
keras-66-8de897a0/metrics.py,8374,4402,19,19,3974,29.8058,428,12776,29805800
keras-66-8de897a0/metrics_utils.py,1913,196,18,12,1721,6.346,332,2109,6346000
keras-66-8de897a0/tensorflow_backend.py,12003,11989,22,21,18,52.3919,457,23992,52391900
keras-67-4de37bcb/cifar10_cnn.py,1027,1027,12,12,1,3.3332,616,2054,3333200
keras-67-4de37bcb/metrics.py,4402,9844,19,19,6336,45.9418,310,14246,45941800
keras-67-4de37bcb/metrics_utils.py,196,2038,12,18,2220,9.7748,228,2234,9774800
keras-67-4de37bcb/tensorflow_backend.py,11989,12020,21,22,46,71.3075,336,24009,71307500
keras-67-4de37bcb/training_generator.py,4089,4079,26,26,28,18.6858,437,8168,18685800
keras-67-4de37bcb/__init__.py,7,7,6,6,0,0.0452,309,14,45200
keras-68-de27619e/metrics.py,9844,9827,19,19,21,41.4306,474,19671,41430600
keras-69-dcb7a16e/metrics.py,9827,10554,19,19,905,51.5943,395,20381,51594300
keras-69-dcb7a16e/metrics_confusion_matrix_test.py,12699,8803,19,17,4013,51.4563,417,21502,51456300
keras-69-dcb7a16e/metrics_utils.py,2038,2023,18,18,46,10.8586,373,4061,10858600
keras-69-dcb7a16e/tensorflow_backend.py,12020,12003,22,22,19,52.1773,460,24023,52177300
keras-69-dcb7a16e/__init__.py,7,7,6,6,0,0.0441,317,14,44100
keras-70-ab124c3c/metrics_confusion_matrix_test.py,8803,11613,17,19,3514,48.037,425,20416,48037000
keras-71-5dc27d0a/metrics.py,10554,8374,19,19,2232,49.1064,385,18928,49106400
keras-71-5dc27d0a/metrics_confusion_matrix_test.py,11613,6705,19,16,4908,40.9331,447,18318,40933100
keras-71-5dc27d0a/metrics_utils.py,2023,1913,18,18,113,8.5206,461,3936,8520600
keras-72-63c0369b/metrics.py,8374,7935,19,19,496,36.6707,444,16309,36670700
keras-72-63c0369b/metrics_confusion_matrix_test.py,6705,5868,16,16,874,26.883,467,12573,26883000
keras-73-088bda59/metrics.py,7935,5165,19,19,2772,29.7833,439,13100,29783300
keras-73-088bda59/metrics_confusion_matrix_test.py,5868,3274,16,16,2596,27.3937,333,9142,27393700
keras-73-088bda59/metrics_utils.py,1913,1722,18,18,256,9.7959,371,3635,9795900
keras-74-d8300241/metrics.py,5165,4402,19,19,765,20.7872,460,9567,20787200
keras-74-d8300241/metrics_utils.py,1722,196,18,12,1530,5.4096,354,1918,5409600
keras-74-d8300241/tensorflow_backend.py,12003,11989,22,21,18,51.8615,462,23992,51861500
keras-75-38e38315/metrics.py,4402,4325,19,19,119,27.5909,316,8727,27590900
keras-76-680be2e1/losses.py,3812,3799,16,16,29,17.2014,442,7611,17201400
keras-76-680be2e1/metrics.py,4325,3847,19,19,488,24.9511,327,8172,24951100
keras-76-680be2e1/metrics_test.py,13238,10146,16,16,3096,75.3801,310,23384,75380100
keras-77-73106d57/metrics.py,3847,3427,19,19,422,15.885,457,7274,15885000
keras-77-73106d57/metrics_test.py,10146,6251,16,16,3895,36.742,446,16397,36742000
keras-78-0fe44e3a/losses.py,3799,3576,16,16,241,18.486,398,7375,18486000
keras-79-9cfc0d17/metrics.py,3427,2865,19,19,589,15.7887,398,6292,15788700
keras-79-9cfc0d17/metrics_test.py,6251,3835,16,16,2418,25.4555,396,10086,25455500
keras-80-969db5ad/metrics.py,2865,3242,19,19,422,18.8229,324,6107,18822900
keras-80-969db5ad/metrics_test.py,3835,4995,16,16,2688,25.2994,349,8830,25299400
keras-81-a82a7e90/metrics.py,3242,2680,19,19,588,15.3397,386,5922,15339700
keras-81-a82a7e90/metrics_test.py,4995,2579,16,16,2418,17.8337,424,7574,17833700
keras-82-655cfd33/base_layer.py,8293,8293,32,32,0,27.2465,608,16586,27246500
keras-83-479fc3a9/theano_backend.py,24661,24664,24,24,29,107.2547,459,49325,107254700
keras-84-3b853b93/base_layer.py,8293,7577,32,32,882,46.274,342,15870,46274000
keras-84-3b853b93/cntk_backend.py,22726,22697,23,23,31,96.9386,468,45423,96938600
keras-84-3b853b93/layers.py,5370,5358,28,28,30,23.4312,457,10728,23431200
keras-84-3b853b93/network.py,10795,10716,30,30,196,48.1506,446,21511,48150600
keras-84-3b853b93/normalization.py,1734,1732,20,20,4,7.3101,474,3466,7310100
keras-84-3b853b93/recurrent.py,17495,17484,28,28,54,73.6452,474,34979,73645200
keras-84-3b853b93/saving.py,9773,9767,30,30,8,41.957,465,19540,41957000
keras-84-3b853b93/tensorflow_backend.py,11989,11963,21,21,28,50.5768,473,23952,50576800
keras-84-3b853b93/theano_backend.py,24664,24629,24,24,37,102.8406,479,49293,102840600
keras-84-3b853b93/wrappers.py,5820,5809,23,23,45,27.6919,419,11629,27691900
keras-84-3b853b93/__init__.py,7,7,6,6,0,0.0416,336,14,41600
keras-85-519fac7c/base_layer.py,7577,7398,32,32,179,32.3392,463,14975,32339200
keras-85-519fac7c/network.py,10716,10798,30,30,101,48.3405,445,21514,48340500
keras-86-a69eaa89/data_utils_test.py,4588,4588,16,16,2,14.5318,631,9176,14531800
keras-87-daebe7ca/data_utils_test.py,4588,4588,16,16,1,14.5199,631,9176,14519900
keras-88-4981b70b/optimizers_test.py,1967,1938,18,18,30,8.5491,456,3905,8549100
keras-89-b10f5ca5/interface_test.py,10783,10827,14,14,60,46.3586,466,21610,46358600
keras-90-bda6bb1d/optimizers_test.py,1938,1909,18,18,30,8.6672,443,3847,8667200
keras-91-67fb3de0/backend_test.py,25688,25688,23,23,1,77.3701,664,51376,77370100
keras-92-91658c51/optimizers_test.py,1909,1909,18,18,2,8.8264,432,3818,8826400
keras-93-04074950/test_training.py,21807,21805,20,20,5,90.7755,480,43612,90775500
keras-94-d4fe07cb/cntk_backend.py,22697,22664,23,23,37,96.3509,470,45361,96350900
keras-94-d4fe07cb/optimizers_test.py,1909,1880,18,18,30,8.1011,467,3789,8101100
keras-95-10c8e50b/losses.py,3576,3576,16,16,20,16.0403,445,7152,16040300
keras-95-10c8e50b/test_documentation.py,1996,1996,18,18,1,6.4021,623,3992,6402100
keras-96-17082f61/backend_test.py,25688,25688,23,23,4,108.2265,474,51376,108226500
keras-98-255a1acd/backend_test.py,25688,25688,23,23,0,79.5851,645,51376,79585100
keras-99-d36c7b2d/losses.py,3576,3554,16,16,36,15.418,462,7130,15418000
keras-100-cca49253/test_training.py,21805,22057,20,20,321,92.5656,473,43862,92565600
keras-101-a996d3d9/backend_test.py,25688,25252,23,23,440,107.8844,472,50940,107884400
keras-101-a996d3d9/conv_filter_visualization.py,1772,1772,20,20,0,5.8042,610,3544,5804200
keras-101-a996d3d9/network.py,10798,10746,30,30,53,46.1117,467,21544,46111700
keras-101-a996d3d9/pretrained_word_embeddings.py,1318,1318,19,19,11,6.3057,418,2636,6305700
keras-101-a996d3d9/recurrent.py,17484,17192,28,28,336,75.3008,460,34676,75300800
keras-101-a996d3d9/regularizers.py,583,583,18,18,16,2.9361,397,1166,2936100
keras-101-a996d3d9/scikit_learn.py,1884,1845,19,19,43,8.4413,441,3729,8441300
keras-101-a996d3d9/test_documentation.py,1996,1982,18,18,16,8.8108,451,3978,8810800
keras-101-a996d3d9/test_model_saving.py,10940,10430,18,18,514,74.7771,285,21370,74777100
keras-101-a996d3d9/test_training.py,22057,21805,20,20,254,92.3761,474,43862,92376100
keras-101-a996d3d9/theano_backend.py,24629,24610,24,24,19,102.2201,481,49239,102220100
keras-101-a996d3d9/wrappers.py,5809,5687,23,23,239,26.2878,437,11496,26287800
keras-102-18c11a30/losses_test.py,10918,10918,21,21,34,33.5842,650,21836,33584200
keras-102-18c11a30/test_training.py,21805,21835,20,20,47,93.9503,464,43640,93950300
keras-103-200358fd/test_training.py,21835,21871,20,20,63,94.0608,464,43706,94060800
keras-104-555ca942/cntk_backend.py,22664,22664,23,23,0,71.3055,635,45328,71305500
keras-104-555ca942/metrics_test.py,2579,2579,16,16,0,8.2084,628,5158,8208400
keras-105-3625bf48/base_layer.py,7398,7374,32,32,52,34.7611,424,14772,34761100
keras-105-3625bf48/layer_utils.py,185,138,15,16,73,1.0181,317,323,1018100
keras-105-3625bf48/models.py,1812,1776,21,21,51,7.9766,449,3588,7976600
keras-105-3625bf48/network.py,10746,10656,30,30,121,47.5116,450,21402,47511600
keras-105-3625bf48/optimizers.py,9663,9647,22,22,25,41.3517,466,19310,41351700
keras-105-3625bf48/recurrent_test.py,9964,9920,18,18,50,43.2168,460,19884,43216800
keras-105-3625bf48/saving.py,9767,9737,30,30,54,42.234,461,19504,42234000
keras-105-3625bf48/tensorflow_backend.py,11963,11945,21,21,26,53.3394,448,23908,53339400
keras-105-3625bf48/test_topology.py,10872,10851,18,18,55,46.4209,467,21723,46420900
keras-105-3625bf48/test_training.py,21871,21804,20,20,73,114.3176,382,43675,114317600
keras-106-d9fae78e/base_layer.py,7374,7374,32,32,0,23.799,619,14748,23799000
keras-106-d9fae78e/training.py,9779,9779,28,28,0,30.2902,645,19558,30290200
keras-107-a47f5e23/metrics.py,2680,2705,19,19,31,11.6031,464,5385,11603100
keras-107-a47f5e23/metrics_utils.py,196,185,12,12,13,0.9579,397,381,957900
keras-107-a47f5e23/test_image_data_tasks.py,755,755,15,15,2,2.3283,648,1510,2328300
keras-107-a47f5e23/test_temporal_data_tasks.py,1919,1919,19,19,3,5.9249,647,3838,5924900
keras-107-a47f5e23/theano_backend.py,24610,24419,24,24,197,104.3016,470,49029,104301600
keras-108-61052bc1/applications_test.py,594,544,14,14,70,2.5861,440,1138,2586100
keras-108-61052bc1/autogen.py,4858,4858,21,21,2,15.7783,615,9716,15778300
keras-108-61052bc1/backend_test.py,25252,25835,23,23,1540,168.7988,302,51087,168798800
keras-108-61052bc1/base_layer.py,7374,6995,32,32,388,48.2429,297,14369,48242900
keras-108-61052bc1/callbacks.py,8014,11228,26,28,3776,50.2456,382,19242,50245600
keras-108-61052bc1/cntk_backend.py,22664,22627,23,23,39,95.8179,472,45291,95817900
keras-108-61052bc1/common.py,469,437,14,14,34,2.1839,414,906,2183900
keras-108-61052bc1/constraints.py,970,979,18,18,187,4.809,405,1949,4809000
keras-108-61052bc1/convolutional_recurrent.py,7956,7897,28,28,71,33.6539,471,15853,33653900
keras-108-61052bc1/conv_filter_visualization.py,1772,1772,20,20,0,6.1003,580,3544,6100300
keras-108-61052bc1/data_utils.py,3934,3993,23,23,68,19.4868,406,7927,19486800
keras-108-61052bc1/data_utils_test.py,4588,5045,16,16,533,27.2478,353,9633,27247800
keras-108-61052bc1/generic_utils.py,4208,4128,25,25,80,17.9205,465,8336,17920500
keras-108-61052bc1/image.py,2190,1565,13,16,1163,13.5088,277,3755,13508800
keras-108-61052bc1/initializers.py,2675,2524,19,19,162,12.5521,414,5199,12552100
keras-108-61052bc1/initializers_test.py,1944,1758,15,15,188,8.1829,452,3702,8182900
keras-108-61052bc1/interface_test.py,10827,11081,14,14,297,45.3647,482,21908,45364700
keras-108-61052bc1/io_utils_test.py,3077,3092,15,15,19,12.9083,477,6169,12908300
keras-108-61052bc1/load_backend.py,912,905,20,20,10,3.9008,465,1817,3900800
keras-108-61052bc1/losses.py,3554,1198,16,16,2467,15.6941,302,4752,15694100
keras-108-61052bc1/losses_test.py,10918,1738,21,19,9285,42.8184,295,12656,42818400
keras-108-61052bc1/metrics.py,2705,737,19,15,1979,9.8075,350,3442,9807500
keras-108-61052bc1/metrics_test.py,2579,2790,16,18,2748,21.6363,248,5369,21636300
keras-108-61052bc1/multi_gpu_utils.py,1237,1253,23,23,41,5.7836,430,2490,5783600
keras-108-61052bc1/network.py,10656,10607,30,30,145,62.4666,340,21263,62466600
keras-108-61052bc1/optimizers.py,9647,8518,22,22,2214,55.5561,326,18165,55556100
keras-108-61052bc1/optimizers_test.py,1880,1935,18,18,308,13.1068,291,3815,13106800
keras-108-61052bc1/pretrained_word_embeddings.py,1318,1318,19,19,12,6.0866,433,2636,6086600
keras-108-61052bc1/recurrent.py,17192,17478,28,28,390,86.5817,400,34670,86581700
keras-108-61052bc1/regularizers.py,583,583,18,18,14,2.8626,407,1166,2862600
keras-108-61052bc1/saving.py,9737,9535,30,30,270,41.969,459,19272,41969000
keras-108-61052bc1/scikit_learn.py,1845,1904,19,19,243,8.8807,422,3749,8880700
keras-108-61052bc1/setup.py,112,112,11,11,4,0.3625,617,224,362500
keras-108-61052bc1/tensorflow_backend.py,11945,25346,21,22,17460,154.8674,240,37291,154867400
keras-108-61052bc1/test_documentation.py,1982,1928,18,18,90,10.3657,377,3910,10365700
keras-108-61052bc1/test_doc_auto_generation.py,544,507,15,15,39,2.3402,449,1051,2340200
keras-108-61052bc1/test_image_data_tasks.py,755,755,15,15,3,2.3499,642,1510,2349900
keras-108-61052bc1/test_loss_weighting.py,1946,3411,14,16,1703,19.2675,278,5357,19267500
keras-108-61052bc1/test_model_saving.py,10430,10937,18,18,554,75.8248,281,21367,75824800
keras-108-61052bc1/test_multiprocessing.py,7016,7033,17,17,23,30.5917,459,14049,30591700
keras-108-61052bc1/test_sequential_model.py,5796,5844,20,20,96,25.5839,454,11640,25583900
keras-108-61052bc1/test_temporal_data_tasks.py,1919,2328,19,19,484,10.1553,418,4247,10155300
keras-108-61052bc1/test_tensorflow_integration.py,493,448,17,14,64,2.3387,402,941,2338700
keras-108-61052bc1/test_topology.py,10851,10807,18,18,101,45.6896,474,21658,45689600
keras-108-61052bc1/test_training.py,21804,20194,20,20,3872,154.6285,271,41998,154628500
keras-108-61052bc1/test_vector_data_tasks.py,877,858,18,18,38,4.3299,400,1735,4329900
keras-108-61052bc1/theano_backend.py,24419,24300,24,24,195,126.1518,386,48719,126151800
keras-108-61052bc1/training.py,9779,9975,28,28,2928,74.1998,266,19754,74199800
keras-108-61052bc1/training_arrays.py,4058,4199,21,21,346,22.1535,372,8257,22153500
keras-108-61052bc1/training_generator.py,4079,4362,26,26,433,22.3268,378,8441,22326800
keras-108-61052bc1/training_utils.py,7203,4855,26,26,2549,44.7676,269,12058,44767600
keras-108-61052bc1/wrappers.py,5687,5809,23,23,262,25.8525,444,11496,25852500
keras-108-61052bc1/wrappers_test.py,6039,6170,20,20,165,27.5291,443,12209,27529100
keras-108-61052bc1/__init__.py,7,7,6,6,0,0.0423,330,14,42300
keras-109-2bb96b6f/image.py,1565,1559,16,16,12,8.4123,371,3124,8412300
keras-110-f6bdacde/applications_test.py,544,594,14,14,80,2.7538,413,1138,2753800
keras-110-f6bdacde/autogen.py,4858,4858,21,21,2,15.5548,624,9716,15554800
keras-110-f6bdacde/backend_test.py,25835,25252,23,23,1535,167.8047,304,51087,167804700
keras-110-f6bdacde/base_layer.py,6995,7001,32,32,6,29.9717,466,13996,29971700
keras-110-f6bdacde/callbacks.py,11228,8014,28,26,3219,42.5381,452,19242,42538100
keras-110-f6bdacde/cntk_backend.py,22627,22664,23,23,46,95.7034,473,45291,95703400
keras-110-f6bdacde/common.py,437,469,14,14,40,2.1413,423,906,2141300
keras-110-f6bdacde/constraints.py,979,970,18,18,21,4.7802,407,1949,4780200
keras-110-f6bdacde/convolutional_recurrent.py,7897,7956,28,28,81,34.0148,466,15853,34014800
keras-110-f6bdacde/conv_filter_visualization.py,1772,1772,20,20,0,5.7533,615,3544,5753300
keras-110-f6bdacde/data_utils.py,3993,3934,23,23,80,19.5722,405,7927,19572200
keras-110-f6bdacde/data_utils_test.py,5045,4588,16,16,462,26.7994,359,9633,26799400
keras-110-f6bdacde/generic_utils.py,4128,4208,25,25,94,18.4896,450,8336,18489600
keras-110-f6bdacde/image.py,1559,2190,16,13,1294,12.6971,295,3749,12697100
keras-110-f6bdacde/initializers.py,2524,2675,19,19,416,13.1752,394,5199,13175200
keras-110-f6bdacde/initializers_test.py,1758,1944,15,15,223,8.5538,432,3702,8553800
keras-110-f6bdacde/interface_test.py,11081,10827,14,14,256,47.8525,457,21908,47852500
keras-110-f6bdacde/io_utils_test.py,3092,3077,15,15,17,13.1302,469,6169,13130200
keras-110-f6bdacde/load_backend.py,905,912,20,20,12,4.0215,451,1817,4021500
keras-110-f6bdacde/losses.py,1198,3554,16,16,2994,18.8622,251,4752,18862200
keras-110-f6bdacde/losses_test.py,1738,10918,19,21,11728,51.9793,243,12656,51979300
keras-110-f6bdacde/metrics.py,737,2680,15,19,2313,14.0543,243,3417,14054300
keras-110-f6bdacde/metrics_test.py,2790,2579,18,16,2798,21.4868,249,5369,21486800
keras-110-f6bdacde/multi_gpu_utils.py,1253,1237,23,23,40,5.5855,445,2490,5585500
keras-110-f6bdacde/network.py,10607,10555,30,30,53,45.1397,468,21162,45139700
keras-110-f6bdacde/optimizers.py,8518,9647,22,22,2232,57.8567,313,18165,57856700
keras-110-f6bdacde/optimizers_test.py,1935,1880,18,18,296,13.6264,279,3815,13626400
keras-110-f6bdacde/pretrained_word_embeddings.py,1318,1318,19,19,11,6.5333,403,2636,6533300
keras-110-f6bdacde/recurrent.py,17478,17192,28,28,340,88.0149,393,34670,88014900
keras-110-f6bdacde/regularizers.py,583,583,18,18,16,2.7969,416,1166,2796900
keras-110-f6bdacde/saving.py,9535,9737,30,30,303,42.4673,453,19272,42467300
keras-110-f6bdacde/scikit_learn.py,1904,1845,19,19,169,8.7368,429,3749,8736800
keras-110-f6bdacde/setup.py,112,112,11,11,4,0.3641,615,224,364100
keras-110-f6bdacde/tensorflow_backend.py,25346,11906,22,21,15203,145.2695,256,37252,145269500
keras-110-f6bdacde/test_documentation.py,1928,1982,18,18,96,10.5947,369,3910,10594700
keras-110-f6bdacde/test_doc_auto_generation.py,507,544,15,15,44,2.3648,444,1051,2364800
keras-110-f6bdacde/test_image_data_tasks.py,755,755,15,15,3,2.4583,614,1510,2458300
keras-110-f6bdacde/test_loss_weighting.py,3411,1946,16,14,1469,18.008,297,5357,18008000
keras-110-f6bdacde/test_model_saving.py,10937,10430,18,18,539,74.1906,288,21367,74190600
keras-110-f6bdacde/test_multiprocessing.py,7033,7016,17,17,19,29.9148,469,14049,29914800
keras-110-f6bdacde/test_sequential_model.py,5844,5796,20,20,93,24.5367,474,11640,24536700
keras-110-f6bdacde/test_temporal_data_tasks.py,2328,1919,19,19,413,9.1024,466,4247,9102400
keras-110-f6bdacde/test_tensorflow_integration.py,448,493,14,17,71,2.3215,405,941,2321500
keras-110-f6bdacde/test_topology.py,10807,10851,18,18,118,46.4118,466,21658,46411800
keras-110-f6bdacde/test_training.py,20194,19004,20,20,2046,139.699,280,39198,139699000
keras-110-f6bdacde/test_vector_data_tasks.py,858,877,18,18,39,4.2692,406,1735,4269200
keras-110-f6bdacde/theano_backend.py,24300,24419,24,24,176,124.6574,390,48719,124657400
keras-110-f6bdacde/training.py,9975,9572,28,28,2806,68.0589,287,19547,68058900
keras-110-f6bdacde/training_arrays.py,4199,4058,21,21,311,23.8279,346,8257,23827900
keras-110-f6bdacde/training_generator.py,4362,4079,26,26,394,21.8179,386,8441,21817900
keras-110-f6bdacde/training_utils.py,4855,7221,26,26,2261,44.6288,270,12076,44628800
keras-110-f6bdacde/wrappers.py,5809,5687,23,23,238,24.9875,460,11496,24987500
keras-110-f6bdacde/wrappers_test.py,6170,6039,20,20,144,28.4543,429,12209,28454300
keras-110-f6bdacde/__init__.py,7,7,6,6,0,0.0375,373,14,37500
keras-111-54462554/training.py,9572,9528,28,28,71,41.6187,458,19100,41618700
keras-112-387aea34/optimizers.py,9647,9297,22,22,1157,55.4876,341,18944,55487600
keras-113-a39f10ac/applications_test.py,594,544,14,14,70,2.5044,454,1138,2504400
keras-113-a39f10ac/autogen.py,4858,4858,21,21,2,15.6352,621,9716,15635200
keras-113-a39f10ac/backend_test.py,25252,25835,23,23,1562,171.9438,297,51087,171943800
keras-113-a39f10ac/base_layer.py,7001,6995,32,32,6,30.3339,461,13996,30333900
keras-113-a39f10ac/callbacks.py,8014,11228,26,28,3776,48.5774,396,19242,48577400
keras-113-a39f10ac/cntk_backend.py,22664,22627,23,23,39,94.3975,479,45291,94397500
keras-113-a39f10ac/common.py,469,437,14,14,34,2.1059,430,906,2105900
keras-113-a39f10ac/constraints.py,970,979,18,18,187,4.8451,402,1949,4845100
keras-113-a39f10ac/convolutional_recurrent.py,7956,7897,28,28,71,34.5019,459,15853,34501900
keras-113-a39f10ac/conv_filter_visualization.py,1772,1772,20,20,0,5.6556,626,3544,5655600
keras-113-a39f10ac/data_utils.py,3934,3993,23,23,68,18.7734,422,7927,18773400
keras-113-a39f10ac/data_utils_test.py,4588,5045,16,16,533,27.3325,352,9633,27332500
keras-113-a39f10ac/generic_utils.py,4208,4128,25,25,80,18.0614,461,8336,18061400
keras-113-a39f10ac/image.py,2190,1559,13,16,1127,12.6803,295,3749,12680300
keras-113-a39f10ac/initializers.py,2675,2524,19,19,162,12.4229,418,5199,12422900
keras-113-a39f10ac/initializers_test.py,1944,1758,15,15,188,8.6112,429,3702,8611200
keras-113-a39f10ac/interface_test.py,10827,11081,14,14,297,47.1281,464,21908,47128100
keras-113-a39f10ac/io_utils_test.py,3077,3092,15,15,19,14.1112,437,6169,14111200
keras-113-a39f10ac/load_backend.py,912,905,20,20,10,4.3198,420,1817,4319800
keras-113-a39f10ac/losses.py,3554,1198,16,16,2473,16.1862,293,4752,16186200
keras-113-a39f10ac/losses_test.py,10918,1738,21,19,9289,43.7333,289,12656,43733300
keras-113-a39f10ac/metrics.py,2680,737,19,15,1954,9.6335,354,3417,9633500
keras-113-a39f10ac/metrics_test.py,2579,2790,16,18,2766,20.4717,262,5369,20471700
keras-113-a39f10ac/multi_gpu_utils.py,1237,1253,23,23,41,5.4802,454,2490,5480200
keras-113-a39f10ac/network.py,10555,10607,30,30,59,45.1936,468,21162,45193600
keras-113-a39f10ac/optimizers.py,9297,8518,22,22,978,41.9545,424,17815,41954500
keras-113-a39f10ac/optimizers_test.py,1880,1935,18,18,309,13.1843,289,3815,13184300
keras-113-a39f10ac/pretrained_word_embeddings.py,1318,1318,19,19,12,5.958,442,2636,5958000
keras-113-a39f10ac/recurrent.py,17192,17478,28,28,390,85.5386,405,34670,85538600
keras-113-a39f10ac/regularizers.py,583,583,18,18,14,2.8525,408,1166,2852500
keras-113-a39f10ac/saving.py,9737,9535,30,30,270,42.5507,452,19272,42550700
keras-113-a39f10ac/scikit_learn.py,1845,1904,19,19,243,8.4173,445,3749,8417300
keras-113-a39f10ac/setup.py,112,112,11,11,4,0.3591,623,224,359100
keras-113-a39f10ac/tensorflow_backend.py,11906,25304,21,22,17442,150.4739,247,37210,150473900
keras-113-a39f10ac/test_documentation.py,1982,1928,18,18,90,10.3907,376,3910,10390700
keras-113-a39f10ac/test_doc_auto_generation.py,544,507,15,15,39,2.2441,468,1051,2244100
keras-113-a39f10ac/test_image_data_tasks.py,755,755,15,15,3,2.3186,651,1510,2318600
keras-113-a39f10ac/test_loss_weighting.py,1946,3411,14,16,1703,18.908,283,5357,18908000
keras-113-a39f10ac/test_model_saving.py,10430,10937,18,18,554,74.5408,286,21367,74540800
keras-113-a39f10ac/test_multiprocessing.py,7016,7033,17,17,23,30.5113,460,14049,30511300
keras-113-a39f10ac/test_sequential_model.py,5796,5844,20,20,96,25.0388,464,11640,25038800
keras-113-a39f10ac/test_temporal_data_tasks.py,1919,2328,19,19,484,9.737,436,4247,9737000
keras-113-a39f10ac/test_tensorflow_integration.py,493,448,17,14,64,2.2903,410,941,2290300
keras-113-a39f10ac/test_topology.py,10851,10807,18,18,102,44.9828,481,21658,44982800
keras-113-a39f10ac/test_training.py,19004,20194,20,20,1931,141.2462,277,39198,141246200
keras-113-a39f10ac/test_vector_data_tasks.py,877,858,18,18,38,4.1622,416,1735,4162200
keras-113-a39f10ac/theano_backend.py,24419,24300,24,24,198,122.5787,397,48719,122578700
keras-113-a39f10ac/training.py,9528,9975,28,28,2621,66.8945,291,19503,66894500
keras-113-a39f10ac/training_arrays.py,4058,4199,21,21,346,22.2565,370,8257,22256500
keras-113-a39f10ac/training_generator.py,4079,4362,26,26,432,21.9714,384,8441,21971400
keras-113-a39f10ac/training_utils.py,7221,4855,26,26,2579,43.7924,275,12076,43792400
keras-113-a39f10ac/wrappers.py,5687,5809,23,23,262,25.3611,453,11496,25361100
keras-113-a39f10ac/wrappers_test.py,6039,6170,20,20,165,26.8124,455,12209,26812400
keras-113-a39f10ac/__init__.py,7,7,6,6,0,0.0318,440,14,31800
keras-115-21efc675/applications_test.py,544,594,14,14,80,2.5681,443,1138,2568100
keras-115-21efc675/autogen.py,4858,4858,21,21,2,16.8253,577,9716,16825300
keras-115-21efc675/backend_test.py,25835,25252,23,23,1502,168.5123,303,51087,168512300
keras-115-21efc675/base_layer.py,6995,7001,32,32,6,29.7498,470,13996,29749800
keras-115-21efc675/callbacks.py,11228,8014,28,26,3219,42.6644,451,19242,42664400
keras-115-21efc675/cntk_backend.py,22627,22664,23,23,46,93.6804,483,45291,93680400
keras-115-21efc675/common.py,437,469,14,14,40,2.0824,435,906,2082400
keras-115-21efc675/constraints.py,979,970,18,18,21,4.7714,408,1949,4771400
keras-115-21efc675/convolutional_recurrent.py,7897,7956,28,28,81,34.221,463,15853,34221000
keras-115-21efc675/conv_filter_visualization.py,1772,1772,20,20,0,5.7782,613,3544,5778200
keras-115-21efc675/data_utils.py,3993,3934,23,23,78,18.6077,426,7927,18607700
keras-115-21efc675/data_utils_test.py,5045,4588,16,16,462,27.1726,354,9633,27172600
keras-115-21efc675/generic_utils.py,4128,4208,25,25,94,18.5837,448,8336,18583700
keras-115-21efc675/image.py,1559,2190,16,13,1305,12.9835,288,3749,12983500
keras-115-21efc675/initializers.py,2524,2675,19,19,416,12.8387,404,5199,12838700
keras-115-21efc675/initializers_test.py,1758,1944,15,15,223,8.6347,428,3702,8634700
keras-115-21efc675/interface_test.py,11081,10827,14,14,256,47.1062,465,21908,47106200
keras-115-21efc675/load_backend.py,905,912,20,20,12,4.295,423,1817,4295000
keras-115-21efc675/losses.py,1198,3554,16,16,2994,18.1836,261,4752,18183600
keras-115-21efc675/losses_test.py,1738,10918,19,21,11728,56.8234,222,12656,56823400
keras-115-21efc675/metrics.py,737,2680,15,19,2313,13.406,254,3417,13406000
keras-115-21efc675/metrics_test.py,2790,2579,18,16,2789,20.6537,259,5369,20653700
keras-115-21efc675/multi_gpu_utils.py,1253,1237,23,23,40,5.7388,433,2490,5738800
keras-115-21efc675/network.py,10607,10555,30,30,54,45.1007,469,21162,45100700
keras-115-21efc675/optimizers.py,8518,9297,22,22,945,42.8742,415,17815,42874200
keras-115-21efc675/optimizers_test.py,1935,1880,18,18,298,13.2476,287,3815,13247600
keras-115-21efc675/pretrained_word_embeddings.py,1318,1318,19,19,11,5.965,441,2636,5965000
keras-115-21efc675/recurrent.py,17478,17192,28,28,341,86.053,402,34670,86053000
keras-115-21efc675/regularizers.py,583,583,18,18,16,2.8014,416,1166,2801400
keras-115-21efc675/saving.py,9535,9737,30,30,303,42.0375,458,19272,42037500
keras-115-21efc675/scikit_learn.py,1904,1845,19,19,169,9.0727,413,3749,9072700
keras-115-21efc675/setup.py,112,112,11,11,4,0.387,578,224,387000
keras-115-21efc675/tensorflow_backend.py,25304,11906,22,21,15140,138.9887,267,37210,138988700
keras-115-21efc675/test_documentation.py,1928,1945,18,18,41,9.8469,393,3873,9846900
keras-115-21efc675/test_image_data_tasks.py,755,755,15,15,3,2.3333,647,1510,2333300
keras-115-21efc675/test_loss_weighting.py,3411,1946,16,14,1469,16.3889,326,5357,16388900
keras-115-21efc675/test_model_saving.py,10937,10430,18,18,543,73.6993,289,21367,73699300
keras-115-21efc675/test_multiprocessing.py,7033,7016,17,17,19,29.936,469,14049,29936000
keras-115-21efc675/test_sequential_model.py,5844,5796,20,20,93,24.9766,466,11640,24976600
keras-115-21efc675/test_temporal_data_tasks.py,2328,1919,19,19,413,9.6413,440,4247,9641300
keras-115-21efc675/test_tensorflow_integration.py,448,493,14,17,71,2.4432,385,941,2443200
keras-115-21efc675/test_topology.py,10807,10851,18,18,119,45.2749,478,21658,45274900
keras-115-21efc675/test_training.py,20194,19004,20,20,2041,141.908,276,39198,141908000
keras-115-21efc675/test_vector_data_tasks.py,858,877,18,18,39,4.2004,413,1735,4200400
keras-115-21efc675/theano_backend.py,24300,24419,24,24,180,124.5587,391,48719,124558700
keras-115-21efc675/training.py,9975,9511,28,28,2817,65.0668,299,19486,65066800
keras-115-21efc675/training_arrays.py,4199,4022,21,21,327,21.849,376,8221,21849000
keras-115-21efc675/training_generator.py,4362,4079,26,26,394,21.5421,391,8441,21542100
keras-115-21efc675/training_utils.py,4855,7221,26,26,2261,45.4497,265,12076,45449700
keras-115-21efc675/wrappers.py,5809,5687,23,23,238,25.2288,455,11496,25228800
keras-115-21efc675/wrappers_test.py,6170,6039,20,20,143,26.8429,454,12209,26842900
keras-115-21efc675/__init__.py,7,7,6,6,0,0.0325,430,14,32500
keras-116-2ccb69df/metrics_test.py,2579,2645,16,16,106,11.4637,455,5224,11463700
keras-116-2ccb69df/training.py,9511,9529,28,28,23,40.5617,469,19040,40561700
keras-117-caceebcb/metrics.py,2680,2683,19,19,5,11.9786,447,5363,11978600
keras-118-8feac19b/losses_test.py,10918,10863,21,21,102,44.1005,493,21781,44100500
keras-118-8feac19b/metrics_test.py,2645,2614,16,16,33,10.7809,487,5259,10780900
keras-118-8feac19b/setup.py,112,112,11,11,2,0.3553,630,224,355300
keras-118-8feac19b/training.py,9529,9502,28,28,33,40.6196,468,19031,40619600
keras-118-8feac19b/training_utils.py,7221,7193,26,26,35,30.6047,470,14414,30604700
keras-119-790c74cb/metrics.py,2683,2683,19,19,62,12.022,446,5366,12022000
keras-119-790c74cb/training.py,9502,9458,28,28,53,46.7262,405,18960,46726200
keras-119-790c74cb/training_utils.py,7193,7141,26,26,58,30.4987,469,14334,30498700
keras-120-fb7f49ef/applications_test.py,594,544,14,14,70,2.5881,439,1138,2588100
keras-120-fb7f49ef/autogen.py,4858,4858,21,21,2,15.4232,629,9716,15423200
keras-120-fb7f49ef/backend_test.py,25252,25835,23,23,1556,164.2257,311,51087,164225700
keras-120-fb7f49ef/base_layer.py,7001,6995,32,32,6,29.7823,469,13996,29782300
keras-120-fb7f49ef/callbacks.py,8014,11228,26,28,3776,47.4232,405,19242,47423200
keras-120-fb7f49ef/cntk_backend.py,22664,22627,23,23,39,93.5327,484,45291,93532700
keras-120-fb7f49ef/common.py,469,437,14,14,34,2.0093,450,906,2009300
keras-120-fb7f49ef/constraints.py,970,979,18,18,187,4.7332,411,1949,4733200
keras-120-fb7f49ef/convolutional_recurrent.py,7956,7897,28,28,71,34.046,465,15853,34046000
keras-120-fb7f49ef/conv_filter_visualization.py,1772,1772,20,20,0,5.5834,634,3544,5583400
keras-120-fb7f49ef/data_utils_test.py,4588,4588,16,16,1,14.1388,648,9176,14138800
keras-120-fb7f49ef/generic_utils.py,4208,4128,25,25,80,17.6357,472,8336,17635700
keras-120-fb7f49ef/image.py,2190,1559,13,16,1141,12.3227,304,3749,12322700
keras-120-fb7f49ef/initializers.py,2675,2524,19,19,162,12.1309,428,5199,12130900
keras-120-fb7f49ef/initializers_test.py,1944,1758,15,15,188,7.7931,475,3702,7793100
keras-120-fb7f49ef/interface_test.py,10827,11081,14,14,297,46.2774,473,21908,46277400
keras-120-fb7f49ef/load_backend.py,912,905,20,20,10,3.9929,455,1817,3992900
keras-120-fb7f49ef/losses.py,3554,1198,16,16,2465,14.7041,323,4752,14704100
keras-120-fb7f49ef/losses_test.py,10863,1738,21,19,9231,41.9221,300,12601,41922100
keras-120-fb7f49ef/metrics.py,2683,737,19,15,1957,9.4986,360,3420,9498600
keras-120-fb7f49ef/metrics_test.py,2614,2790,16,18,2764,20.1488,268,5404,20148800
keras-120-fb7f49ef/multi_gpu_utils.py,1237,1253,23,23,41,5.2979,469,2490,5297900
keras-120-fb7f49ef/network.py,10555,10607,30,30,59,43.7061,484,21162,43706100
keras-120-fb7f49ef/optimizers.py,9297,8518,22,22,974,42.2635,421,17815,42263500
keras-120-fb7f49ef/optimizers_test.py,1880,1935,18,18,310,13.5621,281,3815,13562100
keras-120-fb7f49ef/pretrained_word_embeddings.py,1318,1318,19,19,12,5.9491,443,2636,5949100
keras-120-fb7f49ef/recurrent.py,17192,17478,28,28,390,86.9905,398,34670,86990500
keras-120-fb7f49ef/regularizers.py,583,583,18,18,14,2.8345,411,1166,2834500
keras-120-fb7f49ef/saving.py,9737,9535,30,30,270,41.3861,465,19272,41386100
keras-120-fb7f49ef/scikit_learn.py,1845,1904,19,19,243,9.7026,386,3749,9702600
keras-120-fb7f49ef/setup.py,112,112,11,11,3,0.3749,597,224,374900
keras-120-fb7f49ef/tensorflow_backend.py,11906,25304,21,22,17455,147.7905,251,37210,147790500
keras-120-fb7f49ef/test_documentation.py,1945,1928,18,18,39,9.6217,402,3873,9621700
keras-120-fb7f49ef/test_image_data_tasks.py,755,755,15,15,3,2.2948,658,1510,2294800
keras-120-fb7f49ef/test_loss_weighting.py,1946,3411,14,16,1703,19.177,279,5357,19177000
keras-120-fb7f49ef/test_model_saving.py,10430,10937,18,18,554,75.0528,284,21367,75052800
keras-120-fb7f49ef/test_multiprocessing.py,7016,7033,17,17,23,30.1546,465,14049,30154600
keras-120-fb7f49ef/test_sequential_model.py,5796,5844,20,20,96,24.6669,471,11640,24666900
keras-120-fb7f49ef/test_temporal_data_tasks.py,1919,2328,19,19,484,10.2081,416,4247,10208100
keras-120-fb7f49ef/test_tensorflow_integration.py,493,448,17,14,64,2.3629,398,941,2362900
keras-120-fb7f49ef/test_topology.py,10851,10807,18,18,102,45.172,479,21658,45172000
keras-120-fb7f49ef/test_training.py,19004,18715,20,20,968,132.6646,284,37719,132664600
keras-120-fb7f49ef/test_vector_data_tasks.py,877,858,18,18,38,4.2265,410,1735,4226500
keras-120-fb7f49ef/theano_backend.py,24419,24300,24,24,201,125.867,387,48719,125867000
keras-120-fb7f49ef/training.py,9458,9975,28,28,2646,66.3131,293,19433,66313100
keras-120-fb7f49ef/training_arrays.py,4022,4199,21,21,350,23.0214,357,8221,23021400
keras-120-fb7f49ef/training_generator.py,4079,4240,26,26,244,19.1217,435,8319,19121700
keras-120-fb7f49ef/training_utils.py,7141,4855,26,26,2504,43.1177,278,11996,43117700
keras-120-fb7f49ef/wrappers.py,5687,5809,23,23,261,25.909,443,11496,25909000
keras-120-fb7f49ef/wrappers_test.py,6039,6170,20,20,165,27.2125,448,12209,27212500
keras-120-fb7f49ef/__init__.py,7,7,6,6,0,0.0315,444,14,31500
keras-121-c074416c/scikit_learn.py,1904,1887,19,19,44,8.3799,452,3791,8379900
keras-122-aa289107/scikit_learn.py,1887,1865,19,19,45,8.0698,464,3752,8069800
keras-123-4385de66/setup.py,112,112,11,11,3,0.3571,627,224,357100
keras-123-4385de66/tensorflow_backend.py,25304,25285,22,22,120,108.0359,468,50589,108035900
keras-123-4385de66/test_documentation.py,1928,1914,18,18,16,8.0166,479,3842,8016600
keras-123-4385de66/test_topology.py,10807,10861,18,18,64,45.9445,471,21668,45944500
keras-125-efe72ef4/recurrent.py,17478,17182,28,28,314,73.1263,473,34660,73126300
keras-125-efe72ef4/test_model_saving.py,10937,10427,18,18,514,74.9436,285,21364,74943600
keras-125-efe72ef4/wrappers.py,5809,5687,23,23,242,24.8783,462,11496,24878300
keras-126-ed07472b/regularizers.py,583,583,18,18,16,2.8263,412,1166,2826300
keras-127-ebe3f30f/applications_test.py,544,594,14,14,80,2.5923,438,1138,2592300
keras-127-ebe3f30f/autogen.py,4858,4858,21,21,2,15.6739,619,9716,15673900
keras-127-ebe3f30f/backend_test.py,25835,25252,23,23,1521,167.4716,305,51087,167471600
keras-127-ebe3f30f/base_layer.py,6995,7001,32,32,6,31.3975,445,13996,31397500
keras-127-ebe3f30f/callbacks.py,11228,8014,28,26,3219,42.7234,450,19242,42723400
keras-127-ebe3f30f/cntk_backend.py,22627,22664,23,23,46,94.1432,481,45291,94143200
keras-127-ebe3f30f/common.py,437,469,14,14,40,2.1396,423,906,2139600
keras-127-ebe3f30f/constraints.py,979,970,18,18,21,4.8011,405,1949,4801100
keras-127-ebe3f30f/convolutional_recurrent.py,7897,7956,28,28,81,33.6314,471,15853,33631400
keras-127-ebe3f30f/conv_filter_visualization.py,1772,1772,20,20,0,5.6826,623,3544,5682600
keras-127-ebe3f30f/data_utils_test.py,4588,4588,16,16,1,14.6969,624,9176,14696900
keras-127-ebe3f30f/generic_utils.py,4128,4208,25,25,94,17.7408,469,8336,17740800
keras-127-ebe3f30f/image.py,1559,2190,16,13,1300,12.215,306,3749,12215000
keras-127-ebe3f30f/initializers.py,2524,2675,19,19,416,12.383,419,5199,12383000
keras-127-ebe3f30f/initializers_test.py,1758,1944,15,15,223,8.3552,443,3702,8355200
keras-127-ebe3f30f/interface_test.py,11081,10827,14,14,256,47.6434,459,21908,47643400
keras-127-ebe3f30f/load_backend.py,905,912,20,20,12,3.9454,460,1817,3945400
keras-127-ebe3f30f/losses.py,1198,3554,16,16,2994,17.0466,278,4752,17046600
keras-127-ebe3f30f/losses_test.py,1738,10863,19,21,11663,50.5767,249,12601,50576700
keras-127-ebe3f30f/metrics.py,737,2683,15,19,2315,12.7548,268,3420,12754800
keras-127-ebe3f30f/metrics_test.py,2790,2614,18,16,2805,20.5456,263,5404,20545600
keras-127-ebe3f30f/multi_gpu_utils.py,1253,1237,23,23,40,5.5081,452,2490,5508100
keras-127-ebe3f30f/network.py,10607,10555,30,30,53,44.6354,474,21162,44635400
keras-127-ebe3f30f/optimizers.py,8518,9297,22,22,946,43.4176,410,17815,43417600
keras-127-ebe3f30f/optimizers_test.py,1935,1880,18,18,299,13.4559,283,3815,13455900
keras-127-ebe3f30f/pretrained_word_embeddings.py,1318,1318,19,19,11,6.0773,433,2636,6077300
keras-127-ebe3f30f/recurrent.py,17182,17192,28,28,25,84.8612,405,34374,84861200
keras-127-ebe3f30f/saving.py,9535,9737,30,30,303,40.5947,474,19272,40594700
keras-127-ebe3f30f/scikit_learn.py,1865,1845,19,19,111,8.0402,461,3710,8040200
keras-127-ebe3f30f/tensorflow_backend.py,25285,11906,22,21,15158,137.2631,270,37191,137263100
keras-127-ebe3f30f/test_documentation.py,1914,1945,18,18,39,8.0698,478,3859,8069800
keras-127-ebe3f30f/test_image_data_tasks.py,755,755,15,15,3,2.2889,659,1510,2288900
keras-127-ebe3f30f/test_loss_weighting.py,3411,1946,16,14,1469,16.0719,333,5357,16071900
keras-127-ebe3f30f/test_model_saving.py,10427,10430,18,18,5,42.9285,485,20857,42928500
keras-127-ebe3f30f/test_multiprocessing.py,7033,7016,17,17,19,31.1395,451,14049,31139500
keras-127-ebe3f30f/test_sequential_model.py,5844,5796,20,20,93,23.8876,487,11640,23887600
keras-127-ebe3f30f/test_temporal_data_tasks.py,2328,1919,19,19,413,8.7462,485,4247,8746200
keras-127-ebe3f30f/test_tensorflow_integration.py,448,493,14,17,71,2.3322,403,941,2332200
keras-127-ebe3f30f/test_topology.py,10861,10851,18,18,114,43.9739,493,21712,43973900
keras-127-ebe3f30f/test_training.py,18715,19004,20,20,799,133.8458,281,37719,133845800
keras-127-ebe3f30f/test_vector_data_tasks.py,858,877,18,18,39,4.2947,403,1735,4294700
keras-127-ebe3f30f/theano_backend.py,24300,24320,24,24,74,116.7315,416,48620,116731500
keras-127-ebe3f30f/training.py,9975,9477,28,28,2849,64.7641,300,19452,64764100
keras-127-ebe3f30f/training_arrays.py,4199,4022,21,21,326,21.3958,384,8221,21395800
keras-127-ebe3f30f/training_generator.py,4240,4079,26,26,219,19.3822,429,8319,19382200
keras-127-ebe3f30f/training_utils.py,4855,7141,26,26,2175,44.2537,271,11996,44253700
keras-127-ebe3f30f/wrappers_test.py,6170,6039,20,20,144,26.5239,460,12209,26523900
keras-127-ebe3f30f/__init__.py,7,7,6,6,0,0.0339,412,14,33900
keras-128-3bda5520/applications_test.py,594,544,14,14,70,2.6045,436,1138,2604500
keras-128-3bda5520/autogen.py,4858,4858,21,21,2,15.1848,639,9716,15184800
keras-128-3bda5520/backend_test.py,25252,25399,23,23,1067,164.9656,307,50651,164965600
keras-128-3bda5520/base_layer.py,7001,6995,32,32,6,29.985,466,13996,29985000
keras-128-3bda5520/callbacks.py,8014,11228,26,28,3776,48.0647,400,19242,48064700
keras-128-3bda5520/cntk_backend.py,22664,22627,23,23,39,94.9869,476,45291,94986900
keras-128-3bda5520/common.py,469,437,14,14,34,2.1484,421,906,2148400
keras-128-3bda5520/constraints.py,970,979,18,18,187,4.7333,411,1949,4733300
keras-128-3bda5520/convolutional_recurrent.py,7956,7897,28,28,71,32.5517,487,15853,32551700
keras-128-3bda5520/conv_filter_visualization.py,1772,1772,20,20,0,5.4284,652,3544,5428400
keras-128-3bda5520/data_utils_test.py,4588,4588,16,16,1,13.9194,659,9176,13919400
keras-128-3bda5520/generic_utils.py,4208,4128,25,25,80,16.8469,494,8336,16846900
keras-128-3bda5520/image.py,2190,1559,13,16,1133,12.1211,309,3749,12121100
keras-128-3bda5520/initializers.py,2675,2524,19,19,162,11.6988,444,5199,11698800
keras-128-3bda5520/initializers_test.py,1944,1758,15,15,188,7.6272,485,3702,7627200
keras-128-3bda5520/interface_test.py,10827,11081,14,14,297,44.9232,487,21908,44923200
keras-128-3bda5520/load_backend.py,912,905,20,20,10,4.1763,435,1817,4176300
keras-128-3bda5520/losses.py,3554,1198,16,16,2467,15.8485,299,4752,15848500
keras-128-3bda5520/losses_test.py,10863,1738,21,19,9229,40.4033,311,12601,40403300
keras-128-3bda5520/metrics.py,2683,737,19,15,1957,9.2144,371,3420,9214400
keras-128-3bda5520/metrics_test.py,2614,2790,16,18,2752,20.4997,263,5404,20499700
keras-128-3bda5520/multi_gpu_utils.py,1237,1253,23,23,41,5.52,451,2490,5520000
keras-128-3bda5520/network.py,10555,10607,30,30,59,43.3279,488,21162,43327900
keras-128-3bda5520/optimizers.py,9297,8518,22,22,976,40.4141,440,17815,40414100
keras-128-3bda5520/optimizers_test.py,1880,1935,18,18,309,13.3243,286,3815,13324300
keras-128-3bda5520/pretrained_word_embeddings.py,1318,1318,19,19,12,5.9108,445,2636,5910800
keras-128-3bda5520/recurrent.py,17192,17186,28,28,15,72.0075,477,34378,72007500
keras-128-3bda5520/saving.py,9737,9535,30,30,270,41.6671,462,19272,41667100
keras-128-3bda5520/scikit_learn.py,1845,1865,19,19,117,8.3535,444,3710,8353500
keras-128-3bda5520/tensorflow_backend.py,11906,25285,21,22,17428,147.5383,252,37191,147538300
keras-128-3bda5520/test_documentation.py,1945,1914,18,18,35,7.8306,492,3859,7830600
keras-128-3bda5520/test_image_data_tasks.py,755,755,15,15,3,2.2776,662,1510,2277600
keras-128-3bda5520/test_loss_weighting.py,1946,3411,14,16,1703,18.8231,284,5357,18823100
keras-128-3bda5520/test_model_saving.py,10430,10427,18,18,5,43.7517,476,20857,43751700
keras-128-3bda5520/test_multiprocessing.py,7016,7033,17,17,23,30.2432,464,14049,30243200
keras-128-3bda5520/test_sequential_model.py,5796,5844,20,20,96,25.5205,456,11640,25520500
keras-128-3bda5520/test_temporal_data_tasks.py,1919,2328,19,19,484,9.9662,426,4247,9966200
keras-128-3bda5520/test_tensorflow_integration.py,493,448,17,14,64,2.2317,421,941,2231700
keras-128-3bda5520/test_topology.py,10851,10861,18,18,108,46.6409,465,21712,46640900
keras-128-3bda5520/test_training.py,19004,18715,20,20,939,132.7929,284,37719,132792900
keras-128-3bda5520/test_vector_data_tasks.py,877,858,18,18,38,4.4086,393,1735,4408600
keras-128-3bda5520/theano_backend.py,24320,24281,24,24,42,102.5127,474,48601,102512700
keras-128-3bda5520/training.py,9477,9975,28,28,2652,65.8197,295,19452,65819700
keras-128-3bda5520/training_arrays.py,4022,4199,21,21,350,22.8963,359,8221,22896300
keras-128-3bda5520/training_generator.py,4079,4240,26,26,244,20.1473,412,8319,20147300
keras-128-3bda5520/training_utils.py,7141,4855,26,26,2501,42.0839,285,11996,42083900
keras-128-3bda5520/wrappers_test.py,6039,6170,20,20,165,26.6145,458,12209,26614500
keras-128-3bda5520/__init__.py,7,7,6,6,0,0.033,424,14,33000
keras-129-72a2aa53/applications_test.py,544,594,14,14,80,2.5944,438,1138,2594400
keras-129-72a2aa53/autogen.py,4858,4858,21,21,2,15.3036,634,9716,15303600
keras-129-72a2aa53/backend_test.py,25399,25252,23,23,1152,165.0293,306,50651,165029300
keras-129-72a2aa53/base_layer.py,6995,7001,32,32,6,28.7311,487,13996,28731100
keras-129-72a2aa53/callbacks.py,11228,8014,28,26,3219,40.6437,473,19242,40643700
keras-129-72a2aa53/cntk_backend.py,22627,22664,23,23,46,91.9231,492,45291,91923100
keras-129-72a2aa53/common.py,437,469,14,14,40,2.1449,422,906,2144900
keras-129-72a2aa53/constraints.py,979,970,18,18,21,4.6252,421,1949,4625200
keras-129-72a2aa53/convolutional_recurrent.py,7897,7956,28,28,81,33.7431,469,15853,33743100
keras-129-72a2aa53/conv_filter_visualization.py,1772,1772,20,20,0,5.6951,622,3544,5695100
keras-129-72a2aa53/data_utils_test.py,4588,4588,16,16,1,14.5635,630,9176,14563500
keras-129-72a2aa53/generic_utils.py,4128,4208,25,25,94,17.8662,466,8336,17866200
keras-129-72a2aa53/image.py,1559,2190,16,13,1289,12.4094,302,3749,12409400
keras-129-72a2aa53/initializers.py,2524,2675,19,19,416,12.4958,416,5199,12495800
keras-129-72a2aa53/initializers_test.py,1758,1944,15,15,223,8.6208,429,3702,8620800
keras-129-72a2aa53/interface_test.py,11081,10827,14,14,256,44.8457,488,21908,44845700
keras-129-72a2aa53/load_backend.py,905,912,20,20,12,3.88,468,1817,3880000
keras-129-72a2aa53/losses.py,1198,3554,16,16,3006,16.9517,280,4752,16951700
keras-129-72a2aa53/losses_test.py,1738,10863,19,21,11663,50.6626,248,12601,50662600
keras-129-72a2aa53/metrics.py,737,2683,15,19,2315,12.7958,267,3420,12795800
keras-129-72a2aa53/metrics_test.py,2790,2614,18,16,2809,20.2751,266,5404,20275100
keras-129-72a2aa53/multi_gpu_utils.py,1253,1237,23,23,40,5.3578,464,2490,5357800
keras-129-72a2aa53/network.py,10607,10555,30,30,53,44.5428,475,21162,44542800
keras-129-72a2aa53/optimizers.py,8518,9297,22,22,946,43.2485,411,17815,43248500
keras-129-72a2aa53/optimizers_test.py,1935,1880,18,18,299,13.0004,293,3815,13000400
keras-129-72a2aa53/pretrained_word_embeddings.py,1318,1318,19,19,11,5.8595,449,2636,5859500
keras-129-72a2aa53/recurrent.py,17186,17192,28,28,15,72.3323,475,34378,72332300
keras-129-72a2aa53/saving.py,9535,9737,30,30,303,41.6027,463,19272,41602700
keras-129-72a2aa53/scikit_learn.py,1865,1845,19,19,111,8.5007,436,3710,8500700
keras-129-72a2aa53/tensorflow_backend.py,25285,11906,22,21,15153,139.75,266,37191,139750000
keras-129-72a2aa53/test_documentation.py,1914,1945,18,18,39,8.1968,470,3859,8196800
keras-129-72a2aa53/test_image_data_tasks.py,755,755,15,15,1,2.3554,641,1510,2355400
keras-129-72a2aa53/test_loss_weighting.py,3411,1946,16,14,1469,16.228,330,5357,16228000
keras-129-72a2aa53/test_model_saving.py,10427,10430,18,18,5,43.9481,474,20857,43948100
keras-129-72a2aa53/test_multiprocessing.py,7033,7016,17,17,19,28.8185,487,14049,28818500
keras-129-72a2aa53/test_sequential_model.py,5844,5796,20,20,93,24.4759,475,11640,24475900
keras-129-72a2aa53/test_temporal_data_tasks.py,2328,1919,19,19,411,9.1717,463,4247,9171700
keras-129-72a2aa53/test_tensorflow_integration.py,448,493,14,17,70,2.3642,398,941,2364200
keras-129-72a2aa53/test_topology.py,10861,10851,18,18,114,46.1823,470,21712,46182300
keras-129-72a2aa53/test_training.py,18715,19004,20,20,802,135.1863,279,37719,135186300
keras-129-72a2aa53/test_vector_data_tasks.py,858,877,18,18,36,4.2177,411,1735,4217700
keras-129-72a2aa53/theano_backend.py,24281,24320,24,24,50,101.6794,477,48601,101679400
keras-129-72a2aa53/training.py,9975,9477,28,28,2835,66.4852,292,19452,66485200
keras-129-72a2aa53/training_arrays.py,4199,4022,21,21,318,21.8096,376,8221,21809600
keras-129-72a2aa53/training_generator.py,4240,4079,26,26,219,19.267,431,8319,19267000
keras-129-72a2aa53/training_utils.py,4855,7141,26,26,2175,44.3176,270,11996,44317600
keras-129-72a2aa53/wrappers_test.py,6170,6039,20,20,144,26.6824,457,12209,26682400
keras-129-72a2aa53/__init__.py,7,7,6,6,0,0.0313,447,14,31300
keras-131-b78e3ff9/applications_test.py,594,544,14,14,70,2.5264,450,1138,2526400
keras-131-b78e3ff9/autogen.py,4858,4858,21,21,2,15.3295,633,9716,15329500
keras-131-b78e3ff9/backend_test.py,25252,25399,23,23,1079,159.7719,317,50651,159771900
keras-131-b78e3ff9/base_layer.py,7001,6995,32,32,6,28.6038,489,13996,28603800
keras-131-b78e3ff9/callbacks.py,8014,11228,26,28,3776,45.9125,419,19242,45912500
keras-131-b78e3ff9/cntk_backend.py,22664,22627,23,23,39,93.6053,483,45291,93605300
keras-131-b78e3ff9/common.py,469,437,14,14,34,2.0015,452,906,2001500
keras-131-b78e3ff9/constraints.py,970,979,18,18,187,4.4991,433,1949,4499100
keras-131-b78e3ff9/convolutional_recurrent.py,7956,7897,28,28,71,32.2602,491,15853,32260200
keras-131-b78e3ff9/conv_filter_visualization.py,1772,1772,20,20,0,5.3573,661,3544,5357300
keras-131-b78e3ff9/data_utils_test.py,4588,4588,16,16,1,13.817,664,9176,13817000
keras-131-b78e3ff9/generic_utils.py,4208,4128,25,25,80,17.0457,489,8336,17045700
keras-131-b78e3ff9/image.py,2190,1559,13,16,1139,12.2031,307,3749,12203100
keras-131-b78e3ff9/initializers.py,2675,2524,19,19,162,11.6802,445,5199,11680200
keras-131-b78e3ff9/initializers_test.py,1944,1758,15,15,188,7.5935,487,3702,7593500
keras-131-b78e3ff9/interface_test.py,10827,11081,14,14,297,44.6962,490,21908,44696200
keras-131-b78e3ff9/load_backend.py,912,905,20,20,10,3.8856,467,1817,3885600
keras-131-b78e3ff9/losses.py,3554,1198,16,16,2467,14.7697,321,4752,14769700
keras-131-b78e3ff9/losses_test.py,10863,1738,21,19,9234,39.9642,315,12601,39964200
keras-131-b78e3ff9/metrics.py,2683,737,19,15,1957,9.1272,374,3420,9127200
keras-131-b78e3ff9/metrics_test.py,2614,2790,16,18,2753,21.1424,255,5404,21142400
keras-131-b78e3ff9/multi_gpu_utils.py,1237,1253,23,23,41,5.5612,447,2490,5561200
keras-131-b78e3ff9/network.py,10555,10607,30,30,59,43.6005,485,21162,43600500
keras-131-b78e3ff9/optimizers.py,9297,8518,22,22,984,40.8108,436,17815,40810800
keras-131-b78e3ff9/optimizers_test.py,1880,1935,18,18,309,12.9184,295,3815,12918400
keras-131-b78e3ff9/recurrent.py,17192,17186,28,28,15,69.722,493,34378,69722000
keras-131-b78e3ff9/saving.py,9737,9535,30,30,270,40.3833,477,19272,40383300
keras-131-b78e3ff9/scikit_learn.py,1845,1865,19,19,117,8.4433,439,3710,8443300
keras-131-b78e3ff9/tensorflow_backend.py,11906,25285,21,22,17415,151.5007,245,37191,151500700
keras-131-b78e3ff9/test_documentation.py,1945,1914,18,18,35,8.1727,472,3859,8172700
keras-131-b78e3ff9/test_image_data_tasks.py,755,755,15,15,1,2.4513,615,1510,2451300
keras-131-b78e3ff9/test_loss_weighting.py,1946,3411,14,16,1703,18.8639,283,5357,18863900
keras-131-b78e3ff9/test_model_saving.py,10430,10427,18,18,5,43.3454,481,20857,43345400
keras-131-b78e3ff9/test_multiprocessing.py,7016,7033,17,17,23,29.932,469,14049,29932000
keras-131-b78e3ff9/test_sequential_model.py,5796,5844,20,20,96,24.6889,471,11640,24688900
keras-131-b78e3ff9/test_temporal_data_tasks.py,1919,2328,19,19,482,9.8375,431,4247,9837500
keras-131-b78e3ff9/test_tensorflow_integration.py,493,448,17,14,63,2.3631,398,941,2363100
keras-131-b78e3ff9/test_topology.py,10851,10861,18,18,108,46.7516,464,21712,46751600
keras-131-b78e3ff9/test_training.py,19004,18715,20,20,956,131.3565,287,37719,131356500
keras-131-b78e3ff9/test_vector_data_tasks.py,877,858,18,18,35,4.0305,430,1735,4030500
keras-131-b78e3ff9/theano_backend.py,24320,24281,24,24,42,99.0793,490,48601,99079300
keras-131-b78e3ff9/training.py,9477,9975,28,28,2646,66.4787,292,19452,66478700
keras-131-b78e3ff9/training_arrays.py,4022,4199,21,21,350,23.0402,356,8221,23040200
keras-131-b78e3ff9/training_generator.py,4079,4240,26,26,244,18.9442,439,8319,18944200
keras-131-b78e3ff9/training_utils.py,7141,4855,26,26,2493,41.7225,287,11996,41722500
keras-131-b78e3ff9/wrappers_test.py,6039,6170,20,20,165,25.9765,470,12209,25976500
keras-131-b78e3ff9/__init__.py,7,7,6,6,0,0.0327,428,14,32700
keras-132-87b2b00c/applications_test.py,544,594,14,14,80,2.526,450,1138,2526000
keras-132-87b2b00c/autogen.py,4858,4858,21,21,2,14.8194,655,9716,14819400
keras-132-87b2b00c/backend_test.py,25399,25252,23,23,1161,165.764,305,50651,165764000
keras-132-87b2b00c/base_layer.py,6995,7001,32,32,6,28.9802,482,13996,28980200
keras-132-87b2b00c/callbacks.py,11228,8014,28,26,3219,40.7159,472,19242,40715900
keras-132-87b2b00c/cntk_backend.py,22627,22664,23,23,46,92.4404,489,45291,92440400
keras-132-87b2b00c/common.py,437,469,14,14,40,2.0806,435,906,2080600
keras-132-87b2b00c/constraints.py,979,970,18,18,21,4.7036,414,1949,4703600
keras-132-87b2b00c/convolutional_recurrent.py,7897,7956,28,28,81,33.4685,473,15853,33468500
keras-132-87b2b00c/conv_filter_visualization.py,1772,1772,20,20,0,5.6063,632,3544,5606300
keras-132-87b2b00c/data_utils_test.py,4588,4588,16,16,1,14.3085,641,9176,14308500
keras-132-87b2b00c/generic_utils.py,4128,4208,25,25,94,17.6763,471,8336,17676300
keras-132-87b2b00c/image.py,1559,2190,16,13,1303,13.176,284,3749,13176000
keras-132-87b2b00c/initializers.py,2524,2675,19,19,416,12.8021,406,5199,12802100
keras-132-87b2b00c/initializers_test.py,1758,1944,15,15,223,8.6526,427,3702,8652600
keras-132-87b2b00c/interface_test.py,11081,10827,14,14,256,44.6678,490,21908,44667800
keras-132-87b2b00c/load_backend.py,905,912,20,20,12,4.0386,449,1817,4038600
keras-132-87b2b00c/losses.py,1198,3554,16,16,3006,17.0831,278,4752,17083100
keras-132-87b2b00c/losses_test.py,1738,10863,19,21,11664,50.0589,251,12601,50058900
keras-132-87b2b00c/metrics.py,737,2531,15,19,2136,11.3147,288,3268,11314700
keras-132-87b2b00c/metrics_test.py,2790,2614,18,16,2808,20.2407,266,5404,20240700
keras-132-87b2b00c/multi_gpu_utils.py,1253,1237,23,23,40,5.3376,466,2490,5337600
keras-132-87b2b00c/network.py,10607,10555,30,30,53,42.9786,492,21162,42978600
keras-132-87b2b00c/optimizers.py,8518,9297,22,22,946,41.4083,430,17815,41408300
keras-132-87b2b00c/optimizers_test.py,1935,1880,18,18,295,13.0138,293,3815,13013800
keras-132-87b2b00c/recurrent.py,17186,17192,28,28,15,72.8503,471,34378,72850300
keras-132-87b2b00c/saving.py,9535,9737,30,30,301,40.405,476,19272,40405000
keras-132-87b2b00c/scikit_learn.py,1865,1841,19,19,70,7.8703,470,3706,7870300
keras-132-87b2b00c/tensorflow_backend.py,25285,11906,22,21,15128,135.3352,274,37191,135335200
keras-132-87b2b00c/test_documentation.py,1914,1945,18,18,39,7.9453,485,3859,7945300
keras-132-87b2b00c/test_image_data_tasks.py,755,755,15,15,1,2.2853,660,1510,2285300
keras-132-87b2b00c/test_model_saving.py,10427,10430,18,18,5,42.8217,487,20857,42821700
keras-132-87b2b00c/test_multiprocessing.py,7033,7016,17,17,19,31.3939,447,14049,31393900
keras-132-87b2b00c/test_sequential_model.py,5844,5796,20,20,93,23.9692,485,11640,23969200
keras-132-87b2b00c/test_temporal_data_tasks.py,2328,1919,19,19,411,8.7313,486,4247,8731300
keras-132-87b2b00c/test_tensorflow_integration.py,448,493,14,17,70,2.305,408,941,2305000
keras-132-87b2b00c/test_topology.py,10861,10851,18,18,116,44.5656,487,21712,44565600
keras-132-87b2b00c/test_training.py,18715,19256,20,20,664,131.3724,289,37971,131372400
keras-132-87b2b00c/test_vector_data_tasks.py,858,877,18,18,36,4.0937,423,1735,4093700
keras-132-87b2b00c/theano_backend.py,24281,24320,24,24,50,99.5491,488,48601,99549100
keras-132-87b2b00c/training.py,9975,9558,28,28,2606,62.9319,310,19533,62931900
keras-132-87b2b00c/training_arrays.py,4199,4207,21,21,15,17.1527,490,8406,17152700
keras-132-87b2b00c/training_generator.py,4240,4248,26,26,12,17.4475,486,8488,17447500
keras-132-87b2b00c/training_utils.py,4855,6312,26,26,1096,39.4121,283,11167,39412100
keras-132-87b2b00c/wrappers_test.py,6170,6039,20,20,145,25.9475,470,12209,25947500
keras-132-87b2b00c/__init__.py,7,7,6,6,0,0.0325,430,14,32500
keras-133-3e8a7ca9/training.py,9558,8945,28,28,1589,60.281,306,18503,60281000
keras-133-3e8a7ca9/training_arrays.py,4207,4199,21,21,12,18.6382,451,8406,18638200
keras-133-3e8a7ca9/training_generator.py,4248,4240,26,26,12,17.7841,477,8488,17784100
keras-134-85e530fe/metrics.py,2531,2471,19,19,64,10.1716,491,5002,10171600
keras-134-85e530fe/metrics_test.py,2614,2161,16,16,453,9.6054,497,4775,9605400
keras-135-b365dcfa/metrics.py,2471,2090,19,19,383,10.1524,449,4561,10152400
keras-136-0fc33feb/applications_test.py,594,544,14,14,70,2.4759,459,1138,2475900
keras-136-0fc33feb/autogen.py,4858,4858,21,21,2,15.0829,644,9716,15082900
keras-136-0fc33feb/backend_test.py,25252,25399,23,23,1112,164.7583,307,50651,164758300
keras-136-0fc33feb/base_layer.py,7001,6995,32,32,6,29.7132,471,13996,29713200
keras-136-0fc33feb/callbacks.py,8014,11228,26,28,3776,46.1333,417,19242,46133300
keras-136-0fc33feb/cntk_backend.py,22664,22627,23,23,39,92.6335,488,45291,92633500
keras-136-0fc33feb/common.py,469,437,14,14,34,1.9816,457,906,1981600
keras-136-0fc33feb/constraints.py,970,979,18,18,187,4.5429,429,1949,4542900
keras-136-0fc33feb/convolutional_recurrent.py,7956,7897,28,28,71,32.6821,485,15853,32682100
keras-136-0fc33feb/data_utils_test.py,4588,4588,16,16,1,14.4061,636,9176,14406100
keras-136-0fc33feb/generic_utils.py,4208,4128,25,25,80,17.8581,466,8336,17858100
keras-136-0fc33feb/image.py,2190,1559,13,16,1150,12.1868,307,3749,12186800
keras-136-0fc33feb/initializers.py,2675,2524,19,19,162,11.9197,436,5199,11919700
keras-136-0fc33feb/initializers_test.py,1944,1758,15,15,188,8.0449,460,3702,8044900
keras-136-0fc33feb/interface_test.py,10827,11081,14,14,297,45.1485,485,21908,45148500
keras-136-0fc33feb/load_backend.py,912,905,20,20,10,3.883,467,1817,3883000
keras-136-0fc33feb/losses.py,3554,1198,16,16,2467,14.3846,330,4752,14384600
keras-136-0fc33feb/losses_test.py,10863,1738,21,19,9227,39.1206,322,12601,39120600
keras-136-0fc33feb/metrics.py,2090,737,19,15,1362,6.618,427,2827,6618000
keras-136-0fc33feb/metrics_test.py,2161,2790,16,18,2742,18.4142,268,4951,18414200
keras-136-0fc33feb/multi_gpu_utils.py,1237,1253,23,23,41,5.255,473,2490,5255000
keras-136-0fc33feb/network.py,10555,10607,30,30,59,43.3649,487,21162,43364900
keras-136-0fc33feb/optimizers.py,9297,8518,22,22,973,40.6346,438,17815,40634600
keras-136-0fc33feb/optimizers_test.py,1880,1935,18,18,308,13.0173,293,3815,13017300
keras-136-0fc33feb/recurrent.py,17192,17186,28,28,15,71.6279,479,34378,71627900
keras-136-0fc33feb/saving.py,9737,9535,30,30,268,41.228,467,19272,41228000
keras-136-0fc33feb/scikit_learn.py,1841,1865,19,19,78,8.056,460,3706,8056000
keras-136-0fc33feb/tensorflow_backend.py,11906,25285,21,22,17431,145.58,255,37191,145580000
keras-136-0fc33feb/test_documentation.py,1945,1914,18,18,35,8.1545,473,3859,8154500
keras-136-0fc33feb/test_image_data_tasks.py,755,755,15,15,1,2.2633,667,1510,2263300
keras-136-0fc33feb/test_model_saving.py,10430,10427,18,18,5,42.8814,486,20857,42881400
keras-136-0fc33feb/test_multiprocessing.py,7016,7033,17,17,23,30.0469,467,14049,30046900
keras-136-0fc33feb/test_sequential_model.py,5796,5844,20,20,96,25.8126,450,11640,25812600
keras-136-0fc33feb/test_temporal_data_tasks.py,1919,2328,19,19,482,9.8319,431,4247,9831900
keras-136-0fc33feb/test_tensorflow_integration.py,493,448,17,14,63,2.2482,418,941,2248200
keras-136-0fc33feb/test_topology.py,10851,10861,18,18,108,46.1291,470,21712,46129100
keras-136-0fc33feb/test_training.py,19256,18715,20,20,847,134.9749,281,37971,134974900
keras-136-0fc33feb/test_vector_data_tasks.py,877,858,18,18,35,4.1412,418,1735,4141200
keras-136-0fc33feb/theano_backend.py,24320,24281,24,24,42,100.1371,485,48601,100137100
keras-136-0fc33feb/training.py,8945,9975,28,28,1770,59.3131,318,18920,59313100
keras-136-0fc33feb/training_arrays.py,4199,4199,21,21,3,12.7373,659,8398,12737300
keras-136-0fc33feb/training_utils.py,6312,4855,26,26,1584,38.5462,289,11167,38546200
keras-136-0fc33feb/wrappers_test.py,6039,6170,20,20,165,26.0855,468,12209,26085500
keras-136-0fc33feb/__init__.py,7,7,6,6,0,0.0333,420,14,33300
keras-137-f06524c4/recurrent.py,17186,17186,28,28,1,52.2159,658,34372,52215900
keras-138-d952f0cb/network.py,10607,10555,30,30,54,44.7572,472,21162,44757200
keras-140-0cdff54b/applications_test.py,544,594,14,14,80,2.5193,451,1138,2519300
keras-140-0cdff54b/autogen.py,4858,4858,21,21,2,14.875,653,9716,14875000
keras-140-0cdff54b/backend_test.py,25399,25252,23,23,1147,164.5922,307,50651,164592200
keras-140-0cdff54b/base_layer.py,6995,7001,32,32,6,29.4405,475,13996,29440500
keras-140-0cdff54b/callbacks.py,11228,8014,28,26,3219,42.6626,451,19242,42662600
keras-140-0cdff54b/cntk_backend.py,22627,22664,23,23,46,91.9958,492,45291,91995800
keras-140-0cdff54b/common.py,437,469,14,14,40,2.0527,441,906,2052700
keras-140-0cdff54b/constraints.py,979,970,18,18,21,4.6138,422,1949,4613800
keras-140-0cdff54b/convolutional_recurrent.py,7897,7956,28,28,81,32.852,482,15853,32852000
keras-140-0cdff54b/data_utils_test.py,4588,4588,16,16,1,14.1293,649,9176,14129300
keras-140-0cdff54b/generic_utils.py,4128,4208,25,25,94,17.4113,478,8336,17411300
keras-140-0cdff54b/image.py,1559,2190,16,13,1302,12.0812,310,3749,12081200
keras-140-0cdff54b/initializers.py,2524,2675,19,19,416,11.6858,444,5199,11685800
keras-140-0cdff54b/initializers_test.py,1758,1944,15,15,223,8.1101,456,3702,8110100
keras-140-0cdff54b/interface_test.py,11081,10827,14,14,256,45.3328,483,21908,45332800
keras-140-0cdff54b/load_backend.py,905,912,20,20,12,3.8973,466,1817,3897300
keras-140-0cdff54b/losses.py,1198,3554,16,16,3006,17.7316,267,4752,17731600
keras-140-0cdff54b/losses_test.py,1738,10863,19,21,11664,52.3611,240,12601,52361100
keras-140-0cdff54b/metrics.py,737,2090,15,19,1612,9.4798,298,2827,9479800
keras-140-0cdff54b/metrics_test.py,2790,2161,18,16,2626,18.5755,266,4951,18575500
keras-140-0cdff54b/multi_gpu_utils.py,1253,1237,23,23,40,5.2807,471,2490,5280700
keras-140-0cdff54b/optimizers.py,8518,9297,22,22,945,41.0272,434,17815,41027200
keras-140-0cdff54b/optimizers_test.py,1935,1880,18,18,294,12.7283,299,3815,12728300
keras-140-0cdff54b/recurrent.py,17186,17192,28,28,14,69.984,491,34378,69984000
keras-140-0cdff54b/saving.py,9535,9737,30,30,301,40.6891,473,19272,40689100
keras-140-0cdff54b/scikit_learn.py,1865,1841,19,19,70,7.8869,469,3706,7886900
keras-140-0cdff54b/tensorflow_backend.py,25285,11906,22,21,15130,135.6432,274,37191,135643200
keras-140-0cdff54b/test_documentation.py,1914,1945,18,18,39,7.8528,491,3859,7852800
keras-140-0cdff54b/test_image_data_tasks.py,755,755,15,15,1,2.2443,672,1510,2244300
keras-140-0cdff54b/test_model_saving.py,10427,10430,18,18,5,42.4539,491,20857,42453900
keras-140-0cdff54b/test_multiprocessing.py,7033,7016,17,17,19,28.6643,490,14049,28664300
keras-140-0cdff54b/test_sequential_model.py,5844,5796,20,20,93,23.8748,487,11640,23874800
keras-140-0cdff54b/test_temporal_data_tasks.py,2328,1919,19,19,411,8.7365,486,4247,8736500
keras-140-0cdff54b/test_tensorflow_integration.py,448,493,14,17,70,2.34,402,941,2340000
keras-140-0cdff54b/test_topology.py,10861,10851,18,18,113,44.7393,485,21712,44739300
keras-140-0cdff54b/test_training.py,18715,19256,20,20,671,133.0154,285,37971,133015400
keras-140-0cdff54b/test_vector_data_tasks.py,858,877,18,18,36,4.3134,402,1735,4313400
keras-140-0cdff54b/theano_backend.py,24281,24320,24,24,50,103.4241,469,48601,103424100
keras-140-0cdff54b/training.py,9975,8945,28,28,1928,60.9029,310,18920,60902900
keras-140-0cdff54b/training_arrays.py,4199,4199,21,21,3,13.6007,617,8398,13600700
keras-140-0cdff54b/training_utils.py,4855,6312,26,26,1098,42.2314,264,11167,42231400
keras-140-0cdff54b/wrappers_test.py,6170,6039,20,20,144,25.9146,471,12209,25914600
keras-140-0cdff54b/__init__.py,7,7,6,6,0,0.0323,433,14,32300
keras-141-9e99fcfe/metrics_utils.py,166,168,12,12,4,0.8087,413,334,808700
keras-142-17f68148/applications_test.py,594,583,14,14,82,3.7489,313,1177,3748900
keras-142-17f68148/autogen.py,4858,4858,21,21,2,14.7431,659,9716,14743100
keras-142-17f68148/backend_test.py,25252,25399,23,23,1070,160.6716,315,50651,160671600
keras-142-17f68148/base_layer.py,7001,6995,32,32,6,29.9478,467,13996,29947800
keras-142-17f68148/callbacks.py,8014,11228,26,28,3776,46.3715,414,19242,46371500
keras-142-17f68148/cntk_backend.py,22664,22627,23,23,39,91.8367,493,45291,91836700
keras-142-17f68148/common.py,469,437,14,14,34,1.9666,460,906,1966600
keras-142-17f68148/constraints.py,970,979,18,18,187,4.6328,420,1949,4632800
keras-142-17f68148/convolutional_recurrent.py,7956,7897,28,28,71,32.9828,480,15853,32982800
keras-142-17f68148/data_utils_test.py,4588,4588,16,16,1,13.9115,659,9176,13911500
keras-142-17f68148/generic_utils.py,4208,4128,25,25,80,17.5333,475,8336,17533300
keras-142-17f68148/image.py,2190,1559,13,16,1136,12.6626,296,3749,12662600
keras-142-17f68148/initializers.py,2675,2524,19,19,162,12.0832,430,5199,12083200
keras-142-17f68148/initializers_test.py,1944,1758,15,15,188,7.6159,486,3702,7615900
keras-142-17f68148/interface_test.py,10827,11081,14,14,297,46.4385,471,21908,46438500
keras-142-17f68148/load_backend.py,912,905,20,20,10,4.087,444,1817,4087000
keras-142-17f68148/losses.py,3554,1198,16,16,2467,14.4905,327,4752,14490500
keras-142-17f68148/losses_test.py,10863,1738,21,19,9231,39.0569,322,12601,39056900
keras-142-17f68148/metrics.py,2090,737,19,15,1362,6.6295,426,2827,6629500
keras-142-17f68148/metrics_test.py,2161,2790,16,18,2734,18.3149,270,4951,18314900
keras-142-17f68148/multi_gpu_utils.py,1237,1253,23,23,41,5.2886,470,2490,5288600
keras-142-17f68148/optimizers.py,9297,8518,22,22,972,41.5189,429,17815,41518900
keras-142-17f68148/optimizers_test.py,1880,1935,18,18,309,12.7956,298,3815,12795600
keras-142-17f68148/recurrent.py,17192,17186,28,28,14,69.6676,493,34378,69667600
keras-142-17f68148/saving.py,9737,9535,30,30,268,41.3234,466,19272,41323400
keras-142-17f68148/scikit_learn.py,1841,1865,19,19,78,8.2382,449,3706,8238200
keras-142-17f68148/tensorflow_backend.py,11906,25285,21,22,17434,145.6387,255,37191,145638700
keras-142-17f68148/test_documentation.py,1945,1914,18,18,35,7.8445,491,3859,7844500
keras-142-17f68148/test_image_data_tasks.py,755,755,15,15,1,2.2934,658,1510,2293400
keras-142-17f68148/test_model_saving.py,10430,10427,18,18,5,42.5578,490,20857,42557800
keras-142-17f68148/test_multiprocessing.py,7016,7033,17,17,23,28.84,487,14049,28840000
keras-142-17f68148/test_sequential_model.py,5796,5844,20,20,96,23.9427,486,11640,23942700
keras-142-17f68148/test_temporal_data_tasks.py,1919,2328,19,19,482,9.6707,439,4247,9670700
keras-142-17f68148/test_tensorflow_integration.py,493,448,17,14,63,2.2031,427,941,2203100
keras-142-17f68148/test_topology.py,10851,10861,18,18,107,46.0939,471,21712,46093900
keras-142-17f68148/test_training.py,19256,18715,20,20,841,131.3918,288,37971,131391800
keras-142-17f68148/test_vector_data_tasks.py,877,858,18,18,35,4.0046,433,1735,4004600
keras-142-17f68148/theano_backend.py,24320,24281,24,24,42,100.6233,482,48601,100623300
keras-142-17f68148/training.py,8945,9975,28,28,1773,60.9074,310,18920,60907400
keras-142-17f68148/training_arrays.py,4199,4199,21,21,3,12.7979,656,8398,12797900
keras-142-17f68148/training_utils.py,6312,4855,26,26,1590,38.6189,289,11167,38618900
keras-142-17f68148/wrappers_test.py,6039,6170,20,20,165,26.0444,468,12209,26044400
keras-142-17f68148/__init__.py,7,7,6,6,0,0.0248,564,14,24800
keras-144-3e77ab67/tensorflow_backend.py,25285,25282,22,22,13,103.0148,490,50567,103014800
keras-145-62c6b778/applications_test.py,583,594,14,14,78,3.6859,319,1177,3685900
keras-145-62c6b778/autogen.py,4858,4858,21,21,2,14.7952,656,9716,14795200
keras-145-62c6b778/backend_test.py,25399,25252,23,23,1151,164.3868,308,50651,164386800
keras-145-62c6b778/base_layer.py,6995,7001,32,32,6,29.4667,474,13996,29466700
keras-145-62c6b778/callbacks.py,11228,8014,28,26,3219,42.1388,456,19242,42138800
keras-145-62c6b778/cntk_backend.py,22627,22664,23,23,46,95.5039,474,45291,95503900
keras-145-62c6b778/common.py,437,469,14,14,40,2.2182,408,906,2218200
keras-145-62c6b778/constraints.py,979,970,18,18,21,4.7384,411,1949,4738400
keras-145-62c6b778/convolutional_recurrent.py,7897,7956,28,28,81,32.7922,483,15853,32792200
keras-145-62c6b778/data_utils_test.py,4588,4588,16,16,1,13.9172,659,9176,13917200
keras-145-62c6b778/generic_utils.py,4128,4208,25,25,94,17.2368,483,8336,17236800
keras-145-62c6b778/image.py,1559,2190,16,13,1301,11.9831,312,3749,11983100
keras-145-62c6b778/initializers.py,2524,2675,19,19,416,11.9826,433,5199,11982600
keras-145-62c6b778/initializers_test.py,1758,1944,15,15,223,7.8611,470,3702,7861100
keras-145-62c6b778/interface_test.py,11081,10827,14,14,256,43.4801,503,21908,43480100
keras-145-62c6b778/load_backend.py,905,912,20,20,12,3.8368,473,1817,3836800
keras-145-62c6b778/losses.py,1198,3554,16,16,2994,16.9366,280,4752,16936600
keras-145-62c6b778/losses_test.py,1738,10863,19,21,11664,50.3141,250,12601,50314100
keras-145-62c6b778/metrics.py,737,2063,15,19,1582,9.1026,307,2800,9102600
keras-145-62c6b778/metrics_test.py,2790,2161,18,16,2623,18.3885,269,4951,18388500
keras-145-62c6b778/multi_gpu_utils.py,1253,1237,23,23,40,5.4873,453,2490,5487300
keras-145-62c6b778/optimizers.py,8518,9297,22,22,946,45.7003,389,17815,45700300
keras-145-62c6b778/optimizers_test.py,1935,1880,18,18,297,12.8725,296,3815,12872500
keras-145-62c6b778/recurrent.py,17186,17192,28,28,14,69.8466,492,34378,69846600
keras-145-62c6b778/saving.py,9535,9737,30,30,301,40.229,479,19272,40229000
keras-145-62c6b778/scikit_learn.py,1865,1841,19,19,70,8.4829,436,3706,8482900
keras-145-62c6b778/tensorflow_backend.py,25282,11906,22,21,15125,135.7372,273,37188,135737200
keras-145-62c6b778/test_documentation.py,1914,1945,18,18,39,8.727,442,3859,8727000
keras-145-62c6b778/test_image_data_tasks.py,755,755,15,15,1,2.3735,636,1510,2373500
keras-145-62c6b778/test_model_saving.py,10427,10430,18,18,5,42.9614,485,20857,42961400
keras-145-62c6b778/test_multiprocessing.py,7033,7016,17,17,19,28.6792,489,14049,28679200
keras-145-62c6b778/test_sequential_model.py,5844,5796,20,20,93,23.6417,492,11640,23641700
keras-145-62c6b778/test_temporal_data_tasks.py,2328,1919,19,19,411,8.7526,485,4247,8752600
keras-145-62c6b778/test_tensorflow_integration.py,448,493,14,17,70,2.3254,404,941,2325400
keras-145-62c6b778/test_topology.py,10861,10851,18,18,113,44.7833,484,21712,44783300
keras-145-62c6b778/test_training.py,18715,19256,20,20,666,133.4066,284,37971,133406600
keras-145-62c6b778/test_vector_data_tasks.py,858,877,18,18,36,4.3004,403,1735,4300400
keras-145-62c6b778/theano_backend.py,24281,24320,24,24,50,98.6764,492,48601,98676400
keras-145-62c6b778/training.py,9975,8945,28,28,1958,60.0547,315,18920,60054700
keras-145-62c6b778/training_arrays.py,4199,4199,21,21,3,12.9341,649,8398,12934100
keras-145-62c6b778/training_utils.py,4855,6312,26,26,1097,39.873,280,11167,39873000
keras-145-62c6b778/wrappers_test.py,6170,6039,20,20,144,26.3988,462,12209,26398800
keras-145-62c6b778/__init__.py,7,7,6,6,0,0.0255,549,14,25500
keras-146-c93bd654/cntk_backend.py,22664,22664,23,23,0,68.7555,659,45328,68755500
keras-146-c93bd654/theano_backend.py,24320,24320,24,24,0,73.2264,664,48640,73226400
keras-147-e2c0da40/metrics.py,2063,1968,19,19,103,9.0201,446,4031,9020100
keras-147-e2c0da40/tensorflow_backend.py,11906,11906,21,21,0,36.5777,650,23812,36577700
keras-147-e2c0da40/__init__.py,7,7,6,6,0,0.0274,510,14,27400
keras-148-7350d1e8/metrics.py,1968,2020,19,19,68,8.9441,445,3988,8944100
keras-148-7350d1e8/metrics_test.py,2161,2155,16,16,6,8.6227,500,4316,8622700
keras-149-e73a8ce6/metrics.py,2020,1965,19,19,98,10.718,371,3985,10718000
keras-149-e73a8ce6/metrics_test.py,2155,785,16,16,1371,6.4014,459,2940,6401400
keras-150-fd356715/losses_utils.py,1219,1216,19,19,10,5.2081,467,2435,5208100
keras-150-fd356715/metrics.py,1965,1965,19,19,2,6.0176,653,3930,6017600
keras-150-fd356715/metrics_test.py,785,277,16,15,508,2.3333,455,1062,2333300
keras-151-d01f8cb5/metrics.py,1965,1965,19,19,4,5.9529,660,3930,5952900
keras-151-d01f8cb5/metrics_utils.py,111,111,11,11,2,0.3741,593,222,374100
keras-152-aa04a83d/metrics.py,1965,737,19,15,1237,6.3457,425,2702,6345700
keras-152-aa04a83d/metrics_test.py,277,2790,15,18,3187,12.7901,239,3067,12790100
keras-153-442423e3/losses_utils.py,1216,1182,19,21,63,5.6999,420,2398,5699900
keras-154-613aeff3/applications_test.py,594,583,14,14,83,3.8792,303,1177,3879200
keras-154-613aeff3/autogen.py,4858,4858,21,21,2,14.8004,656,9716,14800400
keras-154-613aeff3/backend_test.py,25252,25399,23,23,1095,161.1726,314,50651,161172600
keras-154-613aeff3/base_layer.py,7001,6995,32,32,6,29.0582,481,13996,29058200
keras-154-613aeff3/callbacks.py,8014,11228,26,28,3776,45.6175,421,19242,45617500
keras-154-613aeff3/cntk_backend.py,22664,22627,23,23,39,92.6959,488,45291,92695900
keras-154-613aeff3/common.py,469,437,14,14,34,2.0303,446,906,2030300
keras-154-613aeff3/constraints.py,970,979,18,18,187,4.6936,415,1949,4693600
keras-154-613aeff3/convolutional_recurrent.py,7956,7897,28,28,73,33.407,474,15853,33407000
keras-154-613aeff3/data_utils_test.py,4588,4588,16,16,1,14.2781,642,9176,14278100
keras-154-613aeff3/generic_utils.py,4208,4128,25,25,80,17.8025,468,8336,17802500
keras-154-613aeff3/image.py,2190,1559,13,16,1124,12.6419,296,3749,12641900
keras-154-613aeff3/initializers.py,2675,2524,19,19,162,12.6864,409,5199,12686400
keras-154-613aeff3/initializers_test.py,1944,1758,15,15,188,8.1656,453,3702,8165600
keras-154-613aeff3/interface_test.py,10827,11081,14,14,297,43.8978,499,21908,43897800
keras-154-613aeff3/load_backend.py,912,905,20,20,10,3.8226,475,1817,3822600
keras-154-613aeff3/losses.py,3554,1198,16,16,2467,14.2724,332,4752,14272400
keras-154-613aeff3/losses_test.py,10863,1738,21,19,9224,39.0155,322,12601,39015500
keras-154-613aeff3/multi_gpu_utils.py,1237,1253,23,23,41,5.2171,477,2490,5217100
keras-154-613aeff3/optimizers.py,9297,8518,22,22,977,40.4621,440,17815,40462100
keras-154-613aeff3/optimizers_test.py,1880,1935,18,18,309,12.8082,297,3815,12808200
keras-154-613aeff3/recurrent.py,17192,17186,28,28,14,69.6905,493,34378,69690500
keras-154-613aeff3/saving.py,9737,9535,30,30,268,44.0676,437,19272,44067600
keras-154-613aeff3/scikit_learn.py,1841,1865,19,19,78,8.5621,432,3706,8562100
keras-154-613aeff3/tensorflow_backend.py,11906,25285,21,22,17434,145.2728,256,37191,145272800
keras-154-613aeff3/test_documentation.py,1945,1914,18,18,35,7.8519,491,3859,7851900
keras-154-613aeff3/test_image_data_tasks.py,755,755,15,15,1,2.2879,659,1510,2287900
keras-154-613aeff3/test_model_saving.py,10430,10427,18,18,5,42.1966,494,20857,42196600
keras-154-613aeff3/test_multiprocessing.py,7016,7033,17,17,23,29.0118,484,14049,29011800
keras-154-613aeff3/test_sequential_model.py,5796,5844,20,20,96,24.6605,472,11640,24660500
keras-154-613aeff3/test_temporal_data_tasks.py,1919,2328,19,19,482,10.2926,412,4247,10292600
keras-154-613aeff3/test_tensorflow_integration.py,493,448,17,14,63,2.2923,410,941,2292300
keras-154-613aeff3/test_topology.py,10851,10861,18,18,108,45.8332,473,21712,45833200
keras-154-613aeff3/test_training.py,19256,18745,20,20,799,131.5182,288,38001,131518200
keras-154-613aeff3/test_vector_data_tasks.py,877,858,18,18,35,4.0372,429,1735,4037200
keras-154-613aeff3/theano_backend.py,24320,24281,24,24,42,99.9648,486,48601,99964800
keras-154-613aeff3/training.py,8945,9975,28,28,1771,59.9096,315,18920,59909600
keras-154-613aeff3/training_arrays.py,4199,4199,21,21,3,12.7065,660,8398,12706500
keras-154-613aeff3/training_utils.py,6312,4855,26,26,1582,38.2614,291,11167,38261400
keras-154-613aeff3/wrappers_test.py,6039,6170,20,20,165,25.7218,474,12209,25721800
keras-154-613aeff3/__init__.py,7,7,6,6,0,0.0264,530,14,26400
keras-155-979b636c/applications_test.py,583,594,14,14,77,3.6632,321,1177,3663200
keras-155-979b636c/autogen.py,4858,4858,21,21,2,15.0184,646,9716,15018400
keras-155-979b636c/backend_test.py,25399,25252,23,23,1161,160.517,315,50651,160517000
keras-155-979b636c/base_layer.py,6995,7001,32,32,6,28.6286,488,13996,28628600
keras-155-979b636c/callbacks.py,11228,8014,28,26,3219,40.3718,476,19242,40371800
keras-155-979b636c/cntk_backend.py,22627,22664,23,23,46,92.3605,490,45291,92360500
keras-155-979b636c/common.py,437,469,14,14,40,2.0545,440,906,2054500
keras-155-979b636c/constraints.py,979,970,18,18,21,4.6168,422,1949,4616800
keras-155-979b636c/convolutional_recurrent.py,7897,7956,28,28,83,32.6395,485,15853,32639500
keras-155-979b636c/data_utils_test.py,4588,4588,16,16,1,14.3631,638,9176,14363100
keras-155-979b636c/generic_utils.py,4128,4208,25,25,94,18.0575,461,8336,18057500
keras-155-979b636c/image.py,1559,2190,16,13,1302,12.642,296,3749,12642000
keras-155-979b636c/initializers.py,2524,2675,19,19,416,12.6581,410,5199,12658100
keras-155-979b636c/initializers_test.py,1758,1944,15,15,223,8.2116,450,3702,8211600
keras-155-979b636c/interface_test.py,11081,10827,14,14,256,43.7397,500,21908,43739700
keras-155-979b636c/load_backend.py,905,912,20,20,12,3.8097,476,1817,3809700
keras-155-979b636c/losses.py,1198,3554,16,16,2994,16.8426,282,4752,16842600
keras-155-979b636c/losses_test.py,1738,10863,19,21,11664,49.9084,252,12601,49908400
keras-155-979b636c/multi_gpu_utils.py,1253,1237,23,23,40,5.1638,482,2490,5163800
keras-155-979b636c/optimizers.py,8518,9297,22,22,945,41.4213,430,17815,41421300
keras-155-979b636c/optimizers_test.py,1935,1880,18,18,296,12.7866,298,3815,12786600
keras-155-979b636c/recurrent.py,17186,17192,28,28,14,70.2643,489,34378,70264300
keras-155-979b636c/saving.py,9535,9737,30,30,301,45.442,424,19272,45442000
keras-155-979b636c/scikit_learn.py,1865,1841,19,19,70,8.1853,452,3706,8185300
keras-155-979b636c/tensorflow_backend.py,25285,12020,22,21,15136,135.3626,275,37305,135362600
keras-155-979b636c/test_documentation.py,1914,1945,18,18,39,7.8989,488,3859,7898900
keras-155-979b636c/test_image_data_tasks.py,755,755,15,15,1,2.2611,667,1510,2261100
keras-155-979b636c/test_model_saving.py,10427,10430,18,18,5,41.9861,496,20857,41986100
keras-155-979b636c/test_multiprocessing.py,7033,7016,17,17,19,29.2137,480,14049,29213700
keras-155-979b636c/test_sequential_model.py,5844,5796,20,20,93,23.8573,487,11640,23857300
keras-155-979b636c/test_temporal_data_tasks.py,2328,1919,19,19,411,9.3423,454,4247,9342300
keras-155-979b636c/test_tensorflow_integration.py,448,493,14,17,70,2.3616,398,941,2361600
keras-155-979b636c/test_topology.py,10861,10851,18,18,115,44.5658,487,21712,44565800
keras-155-979b636c/test_training.py,18745,19256,20,20,660,131.1307,289,38001,131130700
keras-155-979b636c/test_vector_data_tasks.py,858,877,18,18,36,4.0624,427,1735,4062400
keras-155-979b636c/theano_backend.py,24281,24320,24,24,50,99.411,488,48601,99411000
keras-155-979b636c/training.py,9975,8945,28,28,1948,59.7024,316,18920,59702400
keras-155-979b636c/training_arrays.py,4199,4199,21,21,3,12.5191,670,8398,12519100
keras-155-979b636c/training_utils.py,4855,6312,26,26,1099,39.177,285,11167,39177000
keras-155-979b636c/wrappers_test.py,6170,6039,20,20,144,26.26,464,12209,26260000
keras-155-979b636c/__init__.py,7,7,6,6,0,0.0267,524,14,26700
keras-156-ba78b1bf/losses.py,3554,3554,16,16,11,10.9179,651,7108,10917900
keras-156-ba78b1bf/optimizers.py,9297,9277,22,22,20,38.7719,479,18574,38771900
keras-157-36098bf0/losses.py,3554,2963,16,16,599,15.8614,410,6517,15861400
keras-157-36098bf0/losses_test.py,10863,10368,21,21,616,53.115,399,21231,53115000
keras-158-5949aeed/optimizers.py,9277,9109,22,22,238,38.1592,481,18386,38159200
keras-159-5f37eaac/recurrent.py,17192,17192,28,28,8,51.5774,666,34384,51577400
keras-160-1575b8c3/test_sequential_model.py,5796,5796,20,20,0,16.9698,683,11592,16969800
keras-160-1575b8c3/theano_backend.py,24320,24320,24,24,0,73.2478,664,48640,73247800
keras-161-c714efa3/test_image_data_tasks.py,755,755,15,15,1,2.4837,607,1510,2483700
keras-161-c714efa3/test_temporal_data_tasks.py,1919,2328,19,19,482,10.3057,412,4247,10305700
keras-162-dccb24af/losses.py,2963,2968,16,16,41,13.5722,436,5931,13572200
keras-162-dccb24af/test_documentation.py,1945,1945,18,18,1,5.8463,665,3890,5846300
keras-162-dccb24af/test_sequential_model.py,5796,5844,20,20,96,23.887,487,11640,23887000
keras-162-dccb24af/test_temporal_data_tasks.py,2328,2328,19,19,1,7.406,628,4656,7406000
keras-162-dccb24af/test_vector_data_tasks.py,877,883,18,18,12,3.8407,458,1760,3840700
keras-162-dccb24af/training.py,8945,8870,28,28,164,38.987,456,17815,38987000
keras-163-2d2fb47e/applications_test.py,594,583,14,14,85,3.7803,311,1177,3780300
keras-163-2d2fb47e/autogen.py,4858,4858,21,21,2,15.2012,639,9716,15201200
keras-163-2d2fb47e/backend_test.py,25252,25399,23,23,1080,164.839,307,50651,164839000
keras-163-2d2fb47e/base_layer.py,7001,6995,32,32,6,28.4969,491,13996,28496900
keras-163-2d2fb47e/callbacks.py,8014,11228,26,28,3776,45.7832,420,19242,45783200
keras-163-2d2fb47e/cntk_backend.py,22664,22627,23,23,39,92.5207,489,45291,92520700
keras-163-2d2fb47e/common.py,469,437,14,14,34,2.0366,444,906,2036600
keras-163-2d2fb47e/constraints.py,970,979,18,18,187,4.6955,415,1949,4695500
keras-163-2d2fb47e/convolutional_recurrent.py,7956,7897,28,28,71,33.7448,469,15853,33744800
keras-163-2d2fb47e/data_utils_test.py,4588,4588,16,16,1,14.5948,628,9176,14594800
keras-163-2d2fb47e/generic_utils.py,4208,4128,25,25,80,17.7734,469,8336,17773400
keras-163-2d2fb47e/image.py,2190,1559,13,16,1134,12.6281,296,3749,12628100
keras-163-2d2fb47e/initializers.py,2675,2524,19,19,162,12.4664,417,5199,12466400
keras-163-2d2fb47e/initializers_test.py,1944,1758,15,15,188,7.995,463,3702,7995000
keras-163-2d2fb47e/interface_test.py,10827,11081,14,14,297,44.2385,495,21908,44238500
keras-163-2d2fb47e/load_backend.py,912,905,20,20,10,3.8114,476,1817,3811400
keras-163-2d2fb47e/losses.py,2968,1198,16,16,1878,12.4708,334,4166,12470800
keras-163-2d2fb47e/losses_test.py,10368,1738,21,19,8688,35.509,340,12106,35509000
keras-163-2d2fb47e/multi_gpu_utils.py,1237,1253,23,23,41,5.1732,481,2490,5173200
keras-163-2d2fb47e/optimizers.py,9109,8518,22,22,678,37.7847,466,17627,37784700
keras-163-2d2fb47e/optimizers_test.py,1880,1935,18,18,309,12.8274,297,3815,12827400
keras-163-2d2fb47e/recurrent.py,17192,17186,28,28,6,71.2729,482,34378,71272900
keras-163-2d2fb47e/saving.py,9737,9535,30,30,268,42.2961,455,19272,42296100
keras-163-2d2fb47e/scikit_learn.py,1841,1865,19,19,78,7.9672,465,3706,7967200
keras-163-2d2fb47e/tensorflow_backend.py,12020,25282,21,22,17365,145.1036,257,37302,145103600
keras-163-2d2fb47e/test_documentation.py,1945,1914,18,18,34,7.8609,490,3859,7860900
keras-163-2d2fb47e/test_model_saving.py,10430,10427,18,18,5,42.0815,495,20857,42081500
keras-163-2d2fb47e/test_multiprocessing.py,7016,7033,17,17,23,28.923,485,14049,28923000
keras-163-2d2fb47e/test_tensorflow_integration.py,493,448,17,14,63,2.3218,405,941,2321800
keras-163-2d2fb47e/test_topology.py,10851,10861,18,18,107,47.6677,455,21712,47667700
keras-163-2d2fb47e/test_training.py,19256,18745,20,20,799,130.9427,290,38001,130942700
keras-163-2d2fb47e/test_vector_data_tasks.py,883,858,18,18,30,3.6871,472,1741,3687100
keras-163-2d2fb47e/theano_backend.py,24320,24281,24,24,42,100.0776,485,48601,100077600
keras-163-2d2fb47e/training.py,8870,9975,28,28,1808,60.1169,313,18845,60116900
keras-163-2d2fb47e/training_arrays.py,4199,4199,21,21,3,13.4781,623,8398,13478100
keras-163-2d2fb47e/training_utils.py,6312,4855,26,26,1577,38.6439,288,11167,38643900
keras-163-2d2fb47e/wrappers_test.py,6039,6170,20,20,165,25.871,471,12209,25871000
keras-163-2d2fb47e/__init__.py,7,7,6,6,0,0.0267,524,14,26700
keras-165-b810de65/convolutional_recurrent.py,7897,7897,28,28,2,23.8137,663,15794,23813700
keras-166-c658993c/saving.py,9535,9509,30,30,42,38.9694,488,19044,38969400
keras-167-f312e5ac/convolutional.py,11986,11986,23,23,2,35.9016,667,23972,35901600
keras-167-f312e5ac/convolutional_recurrent.py,7897,7897,28,28,2,24.703,639,15794,24703000
keras-169-cd3f27b5/convolutional_recurrent.py,7897,7897,28,28,2,23.4816,672,15794,23481600
keras-170-910e1247/applications_test.py,583,594,14,14,77,3.6423,323,1177,3642300
keras-170-910e1247/autogen.py,4858,4858,21,21,2,15.0704,644,9716,15070400
keras-170-910e1247/backend_test.py,25399,25252,23,23,1156,159.9038,316,50651,159903800
keras-170-910e1247/base_layer.py,6995,6999,32,32,30,31.7426,440,13994,31742600
keras-170-910e1247/callbacks.py,11228,8014,28,26,3219,40.6134,473,19242,40613400
keras-170-910e1247/cntk_backend.py,22627,22664,23,23,46,92.3587,490,45291,92358700
keras-170-910e1247/common.py,437,469,14,14,40,2.0327,445,906,2032700
keras-170-910e1247/constraints.py,979,970,18,18,21,4.5886,424,1949,4588600
keras-170-910e1247/convolutional_recurrent.py,7897,7956,28,28,81,32.7293,484,15853,32729300
keras-170-910e1247/conv_utils.py,1187,1197,26,26,18,5.3831,442,2384,5383100
keras-170-910e1247/data_utils_test.py,4588,4588,16,16,1,14.0281,654,9176,14028100
keras-170-910e1247/generic_utils.py,4128,4208,25,25,94,17.7069,470,8336,17706900
keras-170-910e1247/image.py,1559,2190,16,13,1294,12.4358,301,3749,12435800
keras-170-910e1247/initializers.py,2524,2675,19,19,416,12.5051,415,5199,12505100
keras-170-910e1247/initializers_test.py,1758,1944,15,15,223,8.2271,449,3702,8227100
keras-170-910e1247/interface_test.py,11081,10827,14,14,256,45.6687,479,21908,45668700
keras-170-910e1247/load_backend.py,905,912,20,20,12,4.0151,452,1817,4015100
keras-170-910e1247/losses.py,1198,2968,16,16,2276,15.8683,262,4166,15868300
keras-170-910e1247/losses_test.py,1738,10368,19,21,11030,48.5163,249,12106,48516300
keras-170-910e1247/multi_gpu_utils.py,1253,1219,23,23,49,5.358,461,2472,5358000
keras-170-910e1247/network.py,10555,10475,30,30,87,42.7126,492,21030,42712600
keras-170-910e1247/optimizers.py,8518,9109,22,22,708,38.4324,458,17627,38432400
keras-170-910e1247/optimizers_test.py,1935,1880,18,18,295,12.7632,298,3815,12763200
keras-170-910e1247/recurrent.py,17186,17170,28,28,25,73.3263,468,34356,73326300
keras-170-910e1247/saving.py,9509,9711,30,30,301,42.2276,455,19220,42227600
keras-170-910e1247/scikit_learn.py,1865,1841,19,19,70,8.4336,439,3706,8433600
keras-170-910e1247/tensorflow_backend.py,25282,12020,22,21,15077,136.9712,272,37302,136971200
keras-170-910e1247/test_documentation.py,1914,1945,18,18,38,8.0123,481,3859,8012300
keras-170-910e1247/test_model_saving.py,10427,10430,18,18,5,42.1297,495,20857,42129700
keras-170-910e1247/test_multiprocessing.py,7033,7016,17,17,19,28.6982,489,14049,28698200
keras-170-910e1247/test_tensorflow_integration.py,448,493,14,17,70,2.3248,404,941,2324800
keras-170-910e1247/test_topology.py,10861,10611,18,18,469,61.5481,348,21472,61548100
keras-170-910e1247/test_training.py,18745,19256,20,20,666,133.6943,284,38001,133694300
keras-170-910e1247/test_vector_data_tasks.py,858,883,18,18,32,3.7534,463,1741,3753400
keras-170-910e1247/theano_backend.py,24281,24320,24,24,50,99.0688,490,48601,99068800
keras-170-910e1247/training.py,9975,8870,28,28,1965,60.8423,309,18845,60842300
keras-170-910e1247/training_arrays.py,4199,4199,21,21,3,13.3768,627,8398,13376800
keras-170-910e1247/training_utils.py,4855,6312,26,26,1098,38.9916,286,11167,38991600
keras-170-910e1247/wrappers_test.py,6170,6039,20,20,143,25.6095,476,12209,25609500
keras-170-910e1247/__init__.py,7,7,6,6,0,0.0257,544,14,25700
keras-171-aa230033/applications_test.py,594,583,14,14,86,3.6883,319,1177,3688300
keras-171-aa230033/autogen.py,4858,4858,21,21,2,14.8012,656,9716,14801200
keras-171-aa230033/backend_test.py,25252,25399,23,23,1084,161.8767,312,50651,161876700
keras-171-aa230033/base_layer.py,6999,6995,32,32,17,34.7175,403,13994,34717500
keras-171-aa230033/callbacks.py,8014,11228,26,28,3776,46.214,416,19242,46214000
keras-171-aa230033/cntk_backend.py,22664,22627,23,23,39,91.6079,494,45291,91607900
keras-171-aa230033/common.py,469,437,14,14,34,1.9898,455,906,1989800
keras-171-aa230033/constraints.py,970,979,18,18,187,4.5566,427,1949,4556600
keras-171-aa230033/convolutional_recurrent.py,7956,7897,28,28,73,32.4737,488,15853,32473700
keras-171-aa230033/data_utils_test.py,4588,4588,16,16,1,13.9578,657,9176,13957800
keras-171-aa230033/generic_utils.py,4208,4128,25,25,80,17.4135,478,8336,17413500
keras-171-aa230033/image.py,2190,1559,13,16,1148,12.476,300,3749,12476000
keras-171-aa230033/initializers.py,2675,2524,19,19,162,12.2071,425,5199,12207100
keras-171-aa230033/initializers_test.py,1944,1758,15,15,188,8.013,461,3702,8013000
keras-171-aa230033/interface_test.py,10827,11081,14,14,297,47.741,458,21908,47741000
keras-171-aa230033/load_backend.py,912,905,20,20,10,3.9149,464,1817,3914900
keras-171-aa230033/losses.py,2968,1198,16,16,1879,12.8338,324,4166,12833800
keras-171-aa230033/losses_test.py,10368,1738,21,19,8690,35.2534,343,12106,35253400
keras-171-aa230033/multi_gpu_utils.py,1219,1253,23,23,64,5.403,457,2472,5403000
keras-171-aa230033/network.py,10475,10555,30,30,93,43.3532,485,21030,43353200
keras-171-aa230033/optimizers.py,9109,8518,22,22,677,37.8972,465,17627,37897200
keras-171-aa230033/optimizers_test.py,1880,1935,18,18,309,12.7056,300,3815,12705600
keras-171-aa230033/recurrent.py,17170,17186,28,28,27,72.4849,473,34356,72484900
keras-171-aa230033/saving.py,9711,9509,30,30,268,41.2065,466,19220,41206500
keras-171-aa230033/scikit_learn.py,1841,1865,19,19,78,8.4444,438,3706,8444400
keras-171-aa230033/tensorflow_backend.py,12020,25282,21,22,17349,146.0423,255,37302,146042300
keras-171-aa230033/test_documentation.py,1945,1914,18,18,34,7.8087,494,3859,7808700
keras-171-aa230033/test_model_saving.py,10430,10427,18,18,5,42.4427,491,20857,42442700
keras-171-aa230033/test_multiprocessing.py,7016,7033,17,17,23,28.7677,488,14049,28767700
keras-171-aa230033/test_tensorflow_integration.py,493,448,17,14,63,2.2177,424,941,2217700
keras-171-aa230033/test_topology.py,10611,10861,18,18,392,63.3236,339,21472,63323600
keras-171-aa230033/test_training.py,19256,18745,20,20,793,130.6427,290,38001,130642700
keras-171-aa230033/test_vector_data_tasks.py,883,858,18,18,30,3.6868,472,1741,3686800
keras-171-aa230033/theano_backend.py,24320,24281,24,24,42,98.778,492,48601,98778000
keras-171-aa230033/training.py,8870,9975,28,28,1813,61.2823,307,18845,61282300
keras-171-aa230033/training_arrays.py,4199,4199,21,21,3,12.705,660,8398,12705000
keras-171-aa230033/training_utils.py,6312,4855,26,26,1582,38.2774,291,11167,38277400
keras-171-aa230033/wrappers_test.py,6039,6170,20,20,165,25.9638,470,12209,25963800
keras-171-aa230033/__init__.py,7,7,6,6,0,0.0261,536,14,26100
keras-172-b2f98988/convolutional_recurrent.py,7897,7897,28,28,2,23.486,672,15794,23486000
keras-172-b2f98988/conv_utils.py,1197,1187,26,26,18,5.4355,438,2384,5435500
keras-173-ab3ef6f3/applications_test.py,583,594,14,14,78,3.6525,322,1177,3652500
keras-173-ab3ef6f3/autogen.py,4858,4858,21,21,2,14.6103,665,9716,14610300
keras-173-ab3ef6f3/backend_test.py,25399,25252,23,23,1153,159.8169,316,50651,159816900
keras-173-ab3ef6f3/base_layer.py,6995,6999,32,32,30,31.4354,445,13994,31435400
keras-173-ab3ef6f3/callbacks.py,11228,8014,28,26,3219,40.0906,479,19242,40090600
keras-173-ab3ef6f3/cntk_backend.py,22627,22664,23,23,46,92.4783,489,45291,92478300
keras-173-ab3ef6f3/common.py,437,469,14,14,40,2.0592,439,906,2059200
keras-173-ab3ef6f3/constraints.py,979,970,18,18,21,4.7229,412,1949,4722900
keras-173-ab3ef6f3/convolutional_recurrent.py,7897,7956,28,28,81,33.3558,475,15853,33355800
keras-173-ab3ef6f3/conv_utils.py,1187,1197,26,26,18,5.5432,430,2384,5543200
keras-173-ab3ef6f3/data_utils_test.py,4588,4588,16,16,1,14.6448,626,9176,14644800
keras-173-ab3ef6f3/image.py,1559,2190,16,13,1294,12.5586,298,3749,12558600
keras-173-ab3ef6f3/initializers.py,2524,2675,19,19,416,12.5788,413,5199,12578800
keras-173-ab3ef6f3/initializers_test.py,1758,1944,15,15,223,8.835,419,3702,8835000
keras-173-ab3ef6f3/interface_test.py,11081,10827,14,14,256,43.3163,505,21908,43316300
keras-173-ab3ef6f3/load_backend.py,905,912,20,20,12,3.8101,476,1817,3810100
keras-173-ab3ef6f3/losses.py,1198,2968,16,16,2301,14.5283,286,4166,14528300
keras-173-ab3ef6f3/losses_test.py,1738,10159,19,21,10762,46.6308,255,11897,46630800
keras-173-ab3ef6f3/multi_gpu_utils.py,1253,1219,23,23,49,5.3739,460,2472,5373900
keras-173-ab3ef6f3/network.py,10555,10475,30,30,87,42.8766,490,21030,42876600
keras-173-ab3ef6f3/optimizers.py,8518,9109,22,22,707,38.76,454,17627,38760000
keras-173-ab3ef6f3/optimizers_test.py,1935,1880,18,18,295,12.6316,302,3815,12631600
keras-173-ab3ef6f3/recurrent.py,17186,17170,28,28,25,74.2351,462,34356,74235100
keras-173-ab3ef6f3/saving.py,9509,9656,30,30,204,40.661,471,19165,40661000
keras-173-ab3ef6f3/tensorflow_backend.py,25282,12020,22,21,15117,135.3574,275,37302,135357400
keras-173-ab3ef6f3/test_documentation.py,1914,1945,18,18,38,8.0414,479,3859,8041400
keras-173-ab3ef6f3/test_multiprocessing.py,7033,7016,17,17,19,28.6534,490,14049,28653400
keras-173-ab3ef6f3/test_tensorflow_integration.py,448,493,14,17,70,2.3426,401,941,2342600
keras-173-ab3ef6f3/test_topology.py,10861,10611,18,18,471,61.6098,348,21472,61609800
keras-173-ab3ef6f3/test_training.py,18745,18663,20,20,170,99.3515,376,37408,99351500
keras-173-ab3ef6f3/test_vector_data_tasks.py,858,883,18,18,32,3.7281,466,1741,3728100
keras-173-ab3ef6f3/theano_backend.py,24281,24320,24,24,50,98.7606,492,48601,98760600
keras-173-ab3ef6f3/training.py,9975,9981,28,28,6,40.3221,494,19956,40322100
keras-173-ab3ef6f3/training_arrays.py,4199,4199,21,21,3,13.1141,640,8398,13114100
keras-173-ab3ef6f3/wrappers_test.py,6170,6039,20,20,144,27.7396,440,12209,27739600
keras-173-ab3ef6f3/__init__.py,7,7,6,6,0,0.0272,514,14,27200
keras-174-99ebe775/losses.py,2968,2504,16,16,513,14.6671,373,5472,14667100
keras-174-99ebe775/losses_test.py,10159,7611,21,21,2550,36.7111,484,17770,36711100
keras-175-e3d20c69/applications_test.py,594,544,14,14,70,2.3959,474,1138,2395900
keras-176-9551d2d1/applications_test.py,544,583,14,14,51,2.4051,468,1127,2405100
keras-177-3d48e278/image.py,2190,1559,13,16,1133,11.9288,314,3749,11928800
keras-178-aa3cc727/autogen.py,4858,4858,21,21,2,14.7021,660,9716,14702100
keras-178-aa3cc727/backend_test.py,25252,25399,23,23,1094,160.3842,315,50651,160384200
keras-178-aa3cc727/base_layer.py,6999,6995,32,32,18,32.754,427,13994,32754000
keras-178-aa3cc727/callbacks.py,8014,11228,26,28,3776,47.3493,406,19242,47349300
keras-178-aa3cc727/cntk_backend.py,22664,22627,23,23,39,95.1605,475,45291,95160500
keras-178-aa3cc727/common.py,469,437,14,14,34,2.0529,441,906,2052900
keras-178-aa3cc727/constraints.py,970,979,18,18,187,4.6397,420,1949,4639700
keras-178-aa3cc727/convolutional_recurrent.py,7956,7897,28,28,71,33.6728,470,15853,33672800
keras-178-aa3cc727/data_utils_test.py,4588,4588,16,16,1,14.2061,645,9176,14206100
keras-178-aa3cc727/initializers.py,2675,2524,19,19,162,12.9029,402,5199,12902900
keras-178-aa3cc727/initializers_test.py,1944,1758,15,15,188,7.9643,464,3702,7964300
keras-178-aa3cc727/interface_test.py,10827,11081,14,14,297,44.0529,497,21908,44052900
keras-178-aa3cc727/load_backend.py,912,905,20,20,10,3.767,482,1817,3767000
keras-178-aa3cc727/losses.py,2504,1198,16,16,1367,9.5954,385,3702,9595400
keras-178-aa3cc727/losses_test.py,7611,1738,21,19,5912,27.3103,342,9349,27310300
keras-178-aa3cc727/multi_gpu_utils.py,1219,1253,23,23,64,5.5598,444,2472,5559800
keras-178-aa3cc727/network.py,10475,10555,30,30,93,43.4091,484,21030,43409100
keras-178-aa3cc727/optimizers.py,9109,8518,22,22,678,38.009,463,17627,38009000
keras-178-aa3cc727/optimizers_test.py,1880,1935,18,18,308,12.7131,300,3815,12713100
keras-178-aa3cc727/recurrent.py,17170,17186,28,28,27,73.4304,467,34356,73430400
keras-178-aa3cc727/saving.py,9656,9509,30,30,182,41.6091,460,19165,41609100
keras-178-aa3cc727/tensorflow_backend.py,12020,25282,21,22,17351,146.1768,255,37302,146176800
keras-178-aa3cc727/test_documentation.py,1945,1914,18,18,34,7.9397,486,3859,7939700
keras-178-aa3cc727/test_multiprocessing.py,7016,7033,17,17,23,28.6951,489,14049,28695100
keras-178-aa3cc727/test_tensorflow_integration.py,493,448,17,14,63,2.2562,417,941,2256200
keras-178-aa3cc727/test_topology.py,10611,10861,18,18,408,62.2955,344,21472,62295500
keras-178-aa3cc727/test_training.py,18663,18745,20,20,183,98.4662,379,37408,98466200
keras-178-aa3cc727/test_vector_data_tasks.py,883,858,18,18,30,3.7035,470,1741,3703500
keras-178-aa3cc727/theano_backend.py,24320,24281,24,24,42,99.2478,489,48601,99247800
keras-178-aa3cc727/training.py,9981,9975,28,28,6,40.3811,494,19956,40381100
keras-178-aa3cc727/training_arrays.py,4199,4199,21,21,3,13.0007,645,8398,13000700
keras-178-aa3cc727/wrappers_test.py,6039,6170,20,20,165,27.205,448,12209,27205000
keras-178-aa3cc727/__init__.py,7,7,6,6,0,0.0376,372,14,37600
keras-180-665b0076/test_topology.py,10861,10861,18,18,1,33.3957,650,21722,33395700
keras-181-08f6bdeb/optimizers.py,8518,9801,22,23,2361,57.6466,317,18319,57646600
keras-181-08f6bdeb/optimizers_test.py,1935,2624,18,18,832,11.3185,402,4559,11318500
keras-182-29f27f33/optimizers.py,9801,8518,23,22,2217,57.1015,320,18319,57101500
keras-182-29f27f33/optimizers_test.py,2624,1935,18,18,738,10.418,437,4559,10418000
keras-183-f870823c/autogen.py,4858,4858,21,21,2,14.9103,651,9716,14910300
keras-183-f870823c/backend_test.py,25399,25252,23,23,1159,161.884,312,50651,161884000
keras-183-f870823c/base_layer.py,6995,6999,32,32,30,32.0503,436,13994,32050300
keras-183-f870823c/callbacks.py,11228,8014,28,26,3219,40.7404,472,19242,40740400
keras-183-f870823c/cntk_backend.py,22627,22664,23,23,46,92.6031,489,45291,92603100
keras-183-f870823c/common.py,437,469,14,14,40,2.1521,420,906,2152100
keras-183-f870823c/constraints.py,979,970,18,18,21,4.911,396,1949,4911000
keras-183-f870823c/convolutional_recurrent.py,7897,7956,28,28,81,33.4761,473,15853,33476100
keras-183-f870823c/data_utils_test.py,4588,4588,16,16,1,13.9122,659,9176,13912200
keras-183-f870823c/initializers.py,2524,2675,19,19,416,11.7466,442,5199,11746600
keras-183-f870823c/initializers_test.py,1758,1944,15,15,223,7.8307,472,3702,7830700
keras-183-f870823c/interface_test.py,11081,10827,14,14,256,43.8198,499,21908,43819800
keras-183-f870823c/load_backend.py,905,912,20,20,12,3.7823,480,1817,3782300
keras-183-f870823c/losses.py,1198,1820,16,16,746,7.6382,395,3018,7638200
keras-183-f870823c/losses_test.py,1738,3085,19,21,1775,16.7419,288,4823,16741900
keras-183-f870823c/multi_gpu_utils.py,1253,1219,23,23,49,5.4115,456,2472,5411500
keras-183-f870823c/network.py,10555,10475,30,30,87,43.0516,488,21030,43051600
keras-183-f870823c/optimizers.py,8518,9109,22,22,710,38.3958,459,17627,38395800
keras-183-f870823c/optimizers_test.py,1935,1880,18,18,294,13.0849,291,3815,13084900
keras-183-f870823c/recurrent.py,17186,17170,28,28,25,73.3165,468,34356,73316500
keras-183-f870823c/saving.py,9509,9656,30,30,204,39.4079,486,19165,39407900
keras-183-f870823c/tensorflow_backend.py,25282,12020,22,21,15089,136.588,273,37302,136588000
keras-183-f870823c/test_documentation.py,1914,1945,18,18,38,7.9095,487,3859,7909500
keras-183-f870823c/test_multiprocessing.py,7033,7016,17,17,19,29.0864,483,14049,29086400
keras-183-f870823c/test_tensorflow_integration.py,448,493,14,17,70,2.2683,414,941,2268300
keras-183-f870823c/test_topology.py,10861,10611,18,18,477,63.368,338,21472,63368000
keras-183-f870823c/test_training.py,18745,18663,20,20,170,98.6048,379,37408,98604800
keras-183-f870823c/test_vector_data_tasks.py,858,883,18,18,32,3.7792,460,1741,3779200
keras-183-f870823c/theano_backend.py,24281,24320,24,24,50,99.3227,489,48601,99322700
keras-183-f870823c/training.py,9975,9981,28,28,6,41.564,480,19956,41564000
keras-183-f870823c/training_arrays.py,4199,4199,21,21,3,13.3685,628,8398,13368500
keras-183-f870823c/wrappers_test.py,6170,6039,20,20,144,26.0682,468,12209,26068200
keras-183-f870823c/__init__.py,7,7,6,6,0,0.0268,522,14,26800
keras-184-0792332f/vis_utils.py,1903,1734,31,31,373,8.2632,440,3637,8263200
keras-185-2f31fae7/autogen.py,4858,4858,21,21,2,14.6249,664,9716,14624900
keras-185-2f31fae7/backend_test.py,25252,25399,23,23,1084,159.8434,316,50651,159843400
keras-185-2f31fae7/base_layer.py,6999,6993,32,32,6,29.8411,468,13992,29841100
keras-185-2f31fae7/callbacks.py,8014,11228,26,28,3776,46.2485,416,19242,46248500
keras-185-2f31fae7/cntk_backend.py,22664,22627,23,23,39,91.8888,492,45291,91888800
keras-185-2f31fae7/common.py,469,437,14,14,34,2.0148,449,906,2014800
keras-185-2f31fae7/constraints.py,970,979,18,18,187,4.6056,423,1949,4605600
keras-185-2f31fae7/convolutional_recurrent.py,7956,7897,28,28,71,32.394,489,15853,32394000
keras-185-2f31fae7/data_utils_test.py,4588,4588,16,16,1,14.3555,639,9176,14355500
keras-185-2f31fae7/initializers.py,2675,2524,19,19,162,12.0426,431,5199,12042600
keras-185-2f31fae7/initializers_test.py,1944,1758,15,15,188,7.7996,474,3702,7799600
keras-185-2f31fae7/interface_test.py,10827,11081,14,14,297,46.0529,475,21908,46052900
keras-185-2f31fae7/load_backend.py,912,905,20,20,10,3.9221,463,1817,3922100
keras-185-2f31fae7/losses.py,1820,1198,16,16,629,6.745,447,3018,6745000
keras-185-2f31fae7/losses_test.py,3085,1738,21,19,1386,15.8174,304,4823,15817400
keras-185-2f31fae7/multi_gpu_utils.py,1219,1253,23,23,64,5.9099,418,2472,5909900
keras-185-2f31fae7/optimizers.py,9109,8518,22,22,678,38.0973,462,17627,38097300
keras-185-2f31fae7/optimizers_test.py,1880,1935,18,18,308,12.6682,301,3815,12668200
keras-185-2f31fae7/recurrent.py,17170,17164,28,28,6,69.3769,494,34334,69376900
keras-185-2f31fae7/saving.py,9656,9509,30,30,182,39.441,485,19165,39441000
keras-185-2f31fae7/tensorflow_backend.py,12020,25282,21,22,17358,149.1521,250,37302,149152100
keras-185-2f31fae7/test_documentation.py,1945,1914,18,18,34,8.214,469,3859,8214000
keras-185-2f31fae7/test_multiprocessing.py,7016,7033,17,17,23,28.7192,489,14049,28719200
keras-185-2f31fae7/test_tensorflow_integration.py,493,448,17,14,63,2.1999,427,941,2199900
keras-185-2f31fae7/test_topology.py,10611,10621,18,18,107,43.9185,483,21232,43918500
keras-185-2f31fae7/test_training.py,18663,18745,20,20,183,99.5224,375,37408,99522400
keras-185-2f31fae7/test_vector_data_tasks.py,883,858,18,18,30,3.7828,460,1741,3782800
keras-185-2f31fae7/theano_backend.py,24320,24281,24,24,42,104.0177,467,48601,104017700
keras-185-2f31fae7/training.py,9981,9975,28,28,6,39.9959,498,19956,39995900
keras-185-2f31fae7/training_arrays.py,4199,4199,21,21,3,12.4913,672,8398,12491300
keras-185-2f31fae7/vis_utils.py,1734,1903,31,31,405,8.4208,431,3637,8420800
keras-185-2f31fae7/wrappers_test.py,6039,6170,20,20,165,25.8017,473,12209,25801700
keras-185-2f31fae7/__init__.py,7,7,6,6,0,0.0257,544,14,25700
keras-187-627bf95c/vis_utils.py,1903,1734,31,31,373,8.3833,433,3637,8383300
keras-189-5430a7b4/autogen.py,4858,4858,21,21,2,14.619,664,9716,14619000
keras-189-5430a7b4/backend_test.py,25399,25252,23,23,1145,160.5245,315,50651,160524500
keras-189-5430a7b4/base_layer.py,6993,6999,32,32,6,29.1124,480,13992,29112400
keras-189-5430a7b4/callbacks.py,11228,8014,28,26,3219,40.461,475,19242,40461000
keras-189-5430a7b4/common.py,437,469,14,14,40,2.0595,439,906,2059500
keras-189-5430a7b4/constraints.py,979,970,18,18,21,4.6259,421,1949,4625900
keras-189-5430a7b4/convolutional_recurrent.py,7897,7956,28,28,81,32.4361,488,15853,32436100
keras-189-5430a7b4/data_utils_test.py,4588,4588,16,16,1,13.7568,667,9176,13756800
keras-189-5430a7b4/initializers.py,2524,2675,19,19,416,11.9051,436,5199,11905100
keras-189-5430a7b4/initializers_test.py,1758,1944,15,15,223,7.8642,470,3702,7864200
keras-189-5430a7b4/interface_test.py,11081,10827,14,14,256,45.8093,478,21908,45809300
keras-189-5430a7b4/load_backend.py,905,912,20,20,12,4.1218,440,1817,4121800
keras-189-5430a7b4/multi_gpu_utils.py,1253,1219,23,23,49,5.6629,436,2472,5662900
keras-189-5430a7b4/optimizers.py,8518,9109,22,22,710,38.6268,456,17627,38626800
keras-189-5430a7b4/optimizers_test.py,1935,1880,18,18,297,12.7619,298,3815,12761900
keras-189-5430a7b4/recurrent.py,17164,17170,28,28,6,70.7802,485,34334,70780200
keras-189-5430a7b4/saving.py,9509,9656,30,30,204,40.2691,475,19165,40269100
keras-189-5430a7b4/tensorflow_backend.py,25282,11984,22,21,15106,136.4962,273,37266,136496200
keras-189-5430a7b4/test_documentation.py,1914,1945,18,18,38,8.2437,468,3859,8243700
keras-189-5430a7b4/test_multiprocessing.py,7033,7016,17,17,19,28.918,485,14049,28918000
keras-189-5430a7b4/test_tensorflow_integration.py,448,493,14,17,70,2.3156,406,941,2315600
keras-189-5430a7b4/test_topology.py,10621,10611,18,18,113,44.2583,479,21232,44258300
keras-189-5430a7b4/test_training.py,18745,18663,20,20,170,98.9319,378,37408,98931900
keras-189-5430a7b4/test_vector_data_tasks.py,858,883,18,18,32,3.85,452,1741,3850000
keras-189-5430a7b4/theano_backend.py,24281,24281,24,24,1,76.1611,637,48562,76161100
keras-189-5430a7b4/training.py,9975,9981,28,28,6,40.461,493,19956,40461000
keras-189-5430a7b4/training_arrays.py,4199,4199,21,21,3,12.616,665,8398,12616000
keras-189-5430a7b4/wrappers_test.py,6170,6039,20,20,145,25.5933,477,12209,25593300
keras-189-5430a7b4/__init__.py,7,7,6,6,0,0.0261,536,14,26100
keras-190-510f9f0b/tensorflow_backend.py,11984,12033,21,21,111,49.5011,485,24017,49501100
keras-191-3b2e5e5a/convolutional_recurrent.py,7956,7952,28,28,6,32.6085,487,15908,32608500
keras-192-9c867473/backend_test.py,25252,25311,23,23,84,104.8668,482,50563,104866800
keras-192-9c867473/tensorflow_backend.py,12033,12022,21,21,13,49.873,482,24055,49873000
keras-193-2dbc83ac/autogen.py,4858,4858,21,21,2,14.7742,657,9716,14774200
keras-193-2dbc83ac/backend_test.py,25311,25399,23,23,1019,160.8351,315,50710,160835100
keras-193-2dbc83ac/base_layer.py,6999,6993,32,32,6,28.3307,493,13992,28330700
keras-193-2dbc83ac/callbacks.py,8014,11228,26,28,3776,46.4065,414,19242,46406500
keras-193-2dbc83ac/common.py,469,437,14,14,34,1.9998,453,906,1999800
keras-193-2dbc83ac/constraints.py,970,979,18,18,187,4.5535,428,1949,4553500
keras-193-2dbc83ac/convolutional_recurrent.py,7952,7897,28,28,67,32.6774,485,15849,32677400
keras-193-2dbc83ac/data_utils_test.py,4588,4588,16,16,1,14.0643,652,9176,14064300
keras-193-2dbc83ac/initializers.py,2675,2524,19,19,162,12.2352,424,5199,12235200
keras-193-2dbc83ac/initializers_test.py,1944,1758,15,15,188,7.8909,469,3702,7890900
keras-193-2dbc83ac/interface_test.py,10827,11081,14,14,297,45.93,476,21908,45930000
keras-193-2dbc83ac/load_backend.py,912,905,20,20,10,4.0161,452,1817,4016100
keras-193-2dbc83ac/multi_gpu_utils.py,1219,1253,23,23,64,5.8922,419,2472,5892200
keras-193-2dbc83ac/optimizers.py,9109,8518,22,22,677,38.606,456,17627,38606000
keras-193-2dbc83ac/optimizers_test.py,1880,1935,18,18,307,12.8803,296,3815,12880300
keras-193-2dbc83ac/recurrent.py,17170,17164,28,28,6,69.4261,494,34334,69426100
keras-193-2dbc83ac/saving.py,9656,9509,30,30,182,39.4124,486,19165,39412400
keras-193-2dbc83ac/tensorflow_backend.py,12022,25282,21,22,17399,147.5364,252,37304,147536400
keras-193-2dbc83ac/test_documentation.py,1945,1914,18,18,34,8.48,455,3859,8480000
keras-193-2dbc83ac/test_multiprocessing.py,7016,7033,17,17,23,28.7444,488,14049,28744400
keras-193-2dbc83ac/test_tensorflow_integration.py,493,448,17,14,63,2.2282,422,941,2228200
keras-193-2dbc83ac/test_topology.py,10611,10621,18,18,107,43.8986,483,21232,43898600
keras-193-2dbc83ac/test_training.py,18663,18745,20,20,183,98.5931,379,37408,98593100
keras-193-2dbc83ac/test_vector_data_tasks.py,883,858,18,18,30,3.7321,466,1741,3732100
keras-193-2dbc83ac/theano_backend.py,24281,24281,24,24,1,73.8715,657,48562,73871500
keras-193-2dbc83ac/training.py,9981,9975,28,28,6,40.7463,489,19956,40746300
keras-193-2dbc83ac/training_arrays.py,4199,4199,21,21,3,12.7022,661,8398,12702200
keras-193-2dbc83ac/wrappers_test.py,6039,6170,20,20,165,25.9124,471,12209,25912400
keras-193-2dbc83ac/__init__.py,7,7,6,6,0,0.0272,514,14,27200
keras-195-9d33a024/data_utils.py,3934,3934,23,23,1,11.7358,670,7868,11735800
keras-198-34231971/test_multiprocessing.py,7033,7033,17,17,30,32.761,429,14066,32761000
keras-199-9416f364/boston_housing.py,405,400,16,16,7,1.74,462,805,1740000
keras-199-9416f364/mnist.py,162,157,12,12,7,0.759,420,319,759000
keras-199-9416f364/reuters.py,782,777,16,16,7,3.3265,468,1559,3326500
keras-200-f69e046e/imdb.py,932,927,17,17,7,3.8684,480,1859,3868400
keras-201-747ef0f1/autogen.py,4858,4858,21,21,2,15.091,643,9716,15091000
keras-201-747ef0f1/backend_test.py,25399,25311,23,23,1090,159.5909,317,50710,159590900
keras-201-747ef0f1/base_layer.py,6993,6999,32,32,6,28.4542,491,13992,28454200
keras-201-747ef0f1/callbacks.py,11228,8014,28,26,3219,40.4072,476,19242,40407200
keras-201-747ef0f1/common.py,437,469,14,14,40,2.0341,445,906,2034100
keras-201-747ef0f1/constraints.py,979,970,18,18,21,4.5261,430,1949,4526100
keras-201-747ef0f1/convolutional_recurrent.py,7897,7952,28,28,76,33.169,477,15849,33169000
keras-201-747ef0f1/data_utils_test.py,4588,4588,16,16,1,14.7519,622,9176,14751900
keras-201-747ef0f1/initializers.py,2524,2675,19,19,416,11.9972,433,5199,11997200
keras-201-747ef0f1/initializers_test.py,1758,1944,15,15,223,7.8979,468,3702,7897900
keras-201-747ef0f1/interface_test.py,11081,10827,14,14,256,44.3729,493,21908,44372900
keras-201-747ef0f1/load_backend.py,905,912,20,20,12,3.8187,475,1817,3818700
keras-201-747ef0f1/multi_gpu_utils.py,1253,1219,23,23,49,5.4262,455,2472,5426200
keras-201-747ef0f1/optimizers.py,8518,9109,22,22,710,38.7791,454,17627,38779100
keras-201-747ef0f1/optimizers_test.py,1935,1880,18,18,296,12.8142,297,3815,12814200
keras-201-747ef0f1/recurrent.py,17164,17170,28,28,6,69.7709,492,34334,69770900
keras-201-747ef0f1/saving.py,9509,9656,30,30,204,40.1744,477,19165,40174400
keras-201-747ef0f1/tensorflow_backend.py,25282,12022,22,21,15133,136.7346,272,37304,136734600
keras-201-747ef0f1/test_documentation.py,1914,1945,18,18,38,8.0304,480,3859,8030400
keras-201-747ef0f1/test_multiprocessing.py,7033,7016,17,17,19,28.6637,490,14049,28663700
keras-201-747ef0f1/test_tensorflow_integration.py,448,493,14,17,70,2.2846,411,941,2284600
keras-201-747ef0f1/test_topology.py,10621,10611,18,18,114,43.8295,484,21232,43829500
keras-201-747ef0f1/test_training.py,18745,18663,20,20,171,99.1222,377,37408,99122200
keras-201-747ef0f1/test_vector_data_tasks.py,858,883,18,18,32,3.9939,435,1741,3993900
keras-201-747ef0f1/theano_backend.py,24281,24281,24,24,1,73.0171,665,48562,73017100
keras-201-747ef0f1/training.py,9975,9981,28,28,6,40.3812,494,19956,40381200
keras-201-747ef0f1/training_arrays.py,4199,4199,21,21,3,12.7594,658,8398,12759400
keras-201-747ef0f1/vis_utils.py,1734,1307,31,26,625,8.799,345,3041,8799000
keras-201-747ef0f1/wrappers_test.py,6170,6039,20,20,145,26.4123,462,12209,26412300
keras-201-747ef0f1/__init__.py,7,7,6,6,0,0.0253,553,14,25300
keras-202-d48c2611/test_multiprocessing.py,7016,7033,17,17,23,28.6889,489,14049,28688900
keras-203-261bcb25/autogen.py,4858,4858,21,21,2,15.8454,613,9716,15845400
keras-203-261bcb25/backend_test.py,25311,25399,23,23,1003,161.0592,314,50710,161059200
keras-203-261bcb25/base_layer.py,6999,6993,32,32,6,28.3672,493,13992,28367200
keras-203-261bcb25/callbacks.py,8014,11228,26,28,3776,45.9016,419,19242,45901600
keras-203-261bcb25/common.py,469,437,14,14,34,2.0834,434,906,2083400
keras-203-261bcb25/constraints.py,970,979,18,18,187,4.8641,400,1949,4864100
keras-203-261bcb25/convolutional_recurrent.py,7952,7897,28,28,67,33.8294,468,15849,33829400
keras-203-261bcb25/data_utils_test.py,4588,4588,16,16,1,14.7351,622,9176,14735100
keras-203-261bcb25/initializers.py,2675,2524,19,19,162,12.4743,416,5199,12474300
keras-203-261bcb25/initializers_test.py,1944,1758,15,15,188,7.7976,474,3702,7797600
keras-203-261bcb25/interface_test.py,10827,11081,14,14,297,43.6275,502,21908,43627500
keras-203-261bcb25/load_backend.py,912,905,20,20,10,3.7731,481,1817,3773100
keras-203-261bcb25/multi_gpu_utils.py,1219,1253,23,23,64,5.398,457,2472,5398000
keras-203-261bcb25/optimizers.py,9109,8518,22,22,673,37.9426,464,17627,37942600
keras-203-261bcb25/optimizers_test.py,1880,1935,18,18,308,12.7964,298,3815,12796400
keras-203-261bcb25/recurrent.py,17170,17164,28,28,6,69.4424,494,34334,69442400
keras-203-261bcb25/saving.py,9656,9509,30,30,182,39.9747,479,19165,39974700
keras-203-261bcb25/tensorflow_backend.py,12022,25282,21,22,17387,146.8443,254,37304,146844300
keras-203-261bcb25/test_documentation.py,1945,1914,18,18,34,7.7849,495,3859,7784900
keras-203-261bcb25/test_tensorflow_integration.py,493,448,17,14,63,2.1935,428,941,2193500
keras-203-261bcb25/test_topology.py,10611,10621,18,18,108,43.9868,482,21232,43986800
keras-203-261bcb25/test_training.py,18663,18745,20,20,183,100.3296,372,37408,100329600
keras-203-261bcb25/test_vector_data_tasks.py,883,858,18,18,30,3.8193,455,1741,3819300
keras-203-261bcb25/theano_backend.py,24281,24281,24,24,1,72.803,667,48562,72803000
keras-203-261bcb25/training.py,9981,9975,28,28,6,40.0133,498,19956,40013300
keras-203-261bcb25/training_arrays.py,4199,4199,21,21,3,12.7074,660,8398,12707400
keras-203-261bcb25/wrappers_test.py,6039,6170,20,20,165,26.2967,464,12209,26296700
keras-203-261bcb25/__init__.py,7,7,6,6,0,0.027,518,14,27000
keras-204-6b8a3bcd/metrics.py,737,725,15,15,28,3.3597,435,1462,3359700
keras-204-6b8a3bcd/metrics_test.py,2790,2736,18,18,66,11.3944,484,5526,11394400
keras-205-32aae344/autogen.py,4858,4858,21,21,2,14.5902,665,9716,14590200
keras-205-32aae344/backend_test.py,25399,25311,23,23,1092,160.6257,315,50710,160625700
keras-205-32aae344/base_layer.py,6993,6999,32,32,6,28.3058,494,13992,28305800
keras-205-32aae344/callbacks.py,11228,8014,28,26,3219,40.7078,472,19242,40707800
keras-205-32aae344/common.py,437,469,14,14,40,1.9937,454,906,1993700
keras-205-32aae344/constraints.py,979,970,18,18,21,4.5947,424,1949,4594700
keras-205-32aae344/convolutional_recurrent.py,7897,7952,28,28,76,32.4211,488,15849,32421100
keras-205-32aae344/data_utils_test.py,4588,4588,16,16,1,13.8507,662,9176,13850700
keras-205-32aae344/initializers.py,2524,2675,19,19,416,12.0046,433,5199,12004600
keras-205-32aae344/initializers_test.py,1758,1944,15,15,223,8.1346,455,3702,8134600
keras-205-32aae344/interface_test.py,11081,10827,14,14,256,46.7281,468,21908,46728100
keras-205-32aae344/load_backend.py,905,912,20,20,12,4.4555,407,1817,4455500
keras-205-32aae344/multi_gpu_utils.py,1253,1219,23,23,49,5.7089,433,2472,5708900
keras-205-32aae344/optimizers.py,8518,9109,22,22,709,38.6895,455,17627,38689500
keras-205-32aae344/optimizers_test.py,1935,1880,18,18,296,12.7852,298,3815,12785200
keras-205-32aae344/recurrent.py,17164,17170,28,28,6,69.4064,494,34334,69406400
keras-205-32aae344/saving.py,9509,9656,30,30,204,39.3236,487,19165,39323600
keras-205-32aae344/tensorflow_backend.py,25282,12022,22,21,15112,138.4355,269,37304,138435500
keras-205-32aae344/test_documentation.py,1914,1945,18,18,38,8.1957,470,3859,8195700
keras-205-32aae344/test_tensorflow_integration.py,448,493,14,17,70,2.3495,400,941,2349500
keras-205-32aae344/test_topology.py,10621,10611,18,18,115,43.6507,486,21232,43650700
keras-205-32aae344/test_training.py,18745,18663,20,20,171,98.7268,378,37408,98726800
keras-205-32aae344/test_vector_data_tasks.py,858,883,18,18,32,3.7494,464,1741,3749400
keras-205-32aae344/theano_backend.py,24281,24281,24,24,1,73.913,657,48562,73913000
keras-205-32aae344/training.py,9975,9981,28,28,6,40.6735,490,19956,40673500
keras-205-32aae344/training_arrays.py,4199,4199,21,21,3,12.6055,666,8398,12605500
keras-205-32aae344/wrappers_test.py,6170,6039,20,20,143,25.5588,477,12209,25558800
keras-205-32aae344/__init__.py,7,7,6,6,0,0.0263,532,14,26300
keras-206-35093bc9/autogen.py,4858,4858,21,21,2,14.7813,657,9716,14781300
keras-206-35093bc9/backend_test.py,25311,25399,23,23,1010,159.9527,317,50710,159952700
keras-206-35093bc9/base_layer.py,6999,6993,32,32,6,28.9003,484,13992,28900300
keras-206-35093bc9/callbacks.py,8014,11228,26,28,3776,45.7185,420,19242,45718500
keras-206-35093bc9/common.py,469,437,14,14,34,1.9457,465,906,1945700
keras-206-35093bc9/constraints.py,970,979,18,18,187,4.5022,432,1949,4502200
keras-206-35093bc9/convolutional_recurrent.py,7952,7897,28,28,67,32.0664,494,15849,32066400
keras-206-35093bc9/data_utils_test.py,4588,4588,16,16,1,13.7907,665,9176,13790700
keras-206-35093bc9/initializers.py,2675,2524,19,19,162,11.6244,447,5199,11624400
keras-206-35093bc9/initializers_test.py,1944,1758,15,15,188,7.4982,493,3702,7498200
keras-206-35093bc9/interface_test.py,10827,11081,14,14,297,44.6756,490,21908,44675600
keras-206-35093bc9/load_backend.py,912,905,20,20,10,3.7766,481,1817,3776600
keras-206-35093bc9/multi_gpu_utils.py,1219,1253,23,23,64,5.461,452,2472,5461000
keras-206-35093bc9/optimizers.py,9109,8518,22,22,675,38.3888,459,17627,38388800
keras-206-35093bc9/optimizers_test.py,1880,1935,18,18,308,13.132,290,3815,13132000
keras-206-35093bc9/recurrent.py,17170,17164,28,28,6,69.8394,491,34334,69839400
keras-206-35093bc9/saving.py,9656,9509,30,30,182,39.0941,490,19165,39094100
keras-206-35093bc9/tensorflow_backend.py,12022,25282,21,22,17415,145.8257,255,37304,145825700
keras-206-35093bc9/test_documentation.py,1945,1914,18,18,34,8.0092,481,3859,8009200
keras-206-35093bc9/test_tensorflow_integration.py,493,448,17,14,63,2.2415,419,941,2241500
keras-206-35093bc9/test_topology.py,10611,10621,18,18,107,44.2224,480,21232,44222400
keras-206-35093bc9/test_training.py,18663,18745,20,20,183,98.3028,380,37408,98302800
keras-206-35093bc9/test_vector_data_tasks.py,883,858,18,18,30,3.7003,470,1741,3700300
keras-206-35093bc9/theano_backend.py,24281,24281,24,24,1,73.2774,662,48562,73277400
keras-206-35093bc9/training.py,9981,9975,28,28,6,40.1494,497,19956,40149400
keras-206-35093bc9/training_arrays.py,4199,4199,21,21,3,12.6537,663,8398,12653700
keras-206-35093bc9/wrappers_test.py,6039,6170,20,20,165,26.8291,455,12209,26829100
keras-206-35093bc9/__init__.py,7,7,6,6,0,0.0299,468,14,29900
keras-207-f1e14ef9/core.py,5928,5928,21,21,1,18.3372,646,11856,18337200
keras-208-b5af431c/constraints.py,979,979,18,18,1,3.0102,650,1958,3010200
keras-210-10970b9d/autogen.py,4858,4858,21,21,2,14.4663,671,9716,14466300
keras-210-10970b9d/backend_test.py,25399,25311,23,23,1084,158.9502,319,50710,158950200
keras-210-10970b9d/base_layer.py,6993,7041,32,32,154,33.268,421,14034,33268000
keras-210-10970b9d/callbacks.py,11228,8014,28,26,3219,40.5834,474,19242,40583400
keras-210-10970b9d/common.py,437,469,14,14,40,2.0129,450,906,2012900
keras-210-10970b9d/constraints.py,979,970,18,18,21,4.5598,427,1949,4559800
keras-210-10970b9d/convolutional_recurrent.py,7897,7952,28,28,76,32.1282,493,15849,32128200
keras-210-10970b9d/data_utils_test.py,4588,4588,16,16,1,13.8435,662,9176,13843500
keras-210-10970b9d/initializers.py,2524,2675,19,19,416,11.7878,441,5199,11787800
keras-210-10970b9d/initializers_test.py,1758,1944,15,15,223,7.8149,473,3702,7814900
keras-210-10970b9d/interface_test.py,11081,10827,14,14,256,44.3949,493,21908,44394900
keras-210-10970b9d/load_backend.py,905,912,20,20,12,3.8225,475,1817,3822500
keras-210-10970b9d/multi_gpu_utils.py,1253,1219,23,23,49,5.3904,458,2472,5390400
keras-210-10970b9d/optimizers.py,8518,9109,22,22,710,38.5703,457,17627,38570300
keras-210-10970b9d/optimizers_test.py,1935,1880,18,18,298,12.895,295,3815,12895000
keras-210-10970b9d/pretrained_word_embeddings.py,1318,1324,19,19,35,5.7357,460,2642,5735700
keras-210-10970b9d/recurrent.py,17164,17170,28,28,6,73.1353,469,34334,73135300
keras-210-10970b9d/saving.py,9509,9656,30,30,204,39.2714,488,19165,39271400
keras-210-10970b9d/tensorflow_backend.py,25282,12022,22,21,15100,134.5701,277,37304,134570100
keras-210-10970b9d/test_documentation.py,1914,1945,18,18,38,7.9161,487,3859,7916100
keras-210-10970b9d/test_tensorflow_integration.py,448,493,14,17,70,2.2923,410,941,2292300
keras-210-10970b9d/test_topology.py,10621,10611,18,18,114,45.0777,471,21232,45077700
keras-210-10970b9d/test_training.py,18745,18663,20,20,170,98.8776,378,37408,98877600
keras-210-10970b9d/test_vector_data_tasks.py,858,883,18,18,32,3.7481,464,1741,3748100
keras-210-10970b9d/theano_backend.py,24281,24281,24,24,1,73.4424,661,48562,73442400
keras-210-10970b9d/training.py,9975,9981,28,28,6,40.1116,497,19956,40111600
keras-210-10970b9d/training_arrays.py,4199,4201,21,21,35,17.1906,488,8400,17190600
keras-210-10970b9d/variational_autoencoder.py,1813,1810,18,18,4,7.548,479,3623,7548000
keras-210-10970b9d/wrappers_test.py,6170,6039,20,20,143,26.0618,468,12209,26061800
keras-210-10970b9d/__init__.py,7,7,6,6,0,0.0276,507,14,27600
keras-211-7d57c58b/backend_test.py,25311,25311,23,23,0,75.8587,667,50622,75858700
keras-212-8c02f4ec/tensorflow_backend.py,12022,12022,21,21,0,36.3797,660,24044,36379700
keras-213-e361a264/backend_test.py,25311,25210,23,23,207,115.2692,438,50521,115269200
keras-213-e361a264/interface_test.py,10827,11081,14,14,297,44.5698,491,21908,44569800
keras-213-e361a264/tensorboard_test.py,2651,3305,15,15,788,13.647,436,5956,13647000
keras-214-30fe4ff1/autogen.py,4858,4858,21,21,2,14.7203,660,9716,14720300
keras-214-30fe4ff1/backend_test.py,25210,25399,23,23,839,160.1167,316,50609,160116700
keras-214-30fe4ff1/base_layer.py,7041,7035,32,32,6,28.4611,494,14076,28461100
keras-214-30fe4ff1/callbacks.py,8014,11228,26,28,3776,45.6422,421,19242,45642200
keras-214-30fe4ff1/common.py,469,437,14,14,34,1.9469,465,906,1946900
keras-214-30fe4ff1/constraints.py,970,979,18,18,187,4.5175,431,1949,4517500
keras-214-30fe4ff1/convolutional_recurrent.py,7952,7897,28,28,67,32.197,492,15849,32197000
keras-214-30fe4ff1/data_utils_test.py,4588,4588,16,16,1,13.7823,665,9176,13782300
keras-214-30fe4ff1/initializers.py,2675,2524,19,19,162,11.7649,441,5199,11764900
keras-214-30fe4ff1/initializers_test.py,1944,1758,15,15,188,7.5795,488,3702,7579500
keras-214-30fe4ff1/load_backend.py,912,905,20,20,10,3.8682,469,1817,3868200
keras-214-30fe4ff1/multi_gpu_utils.py,1219,1253,23,23,64,5.5358,446,2472,5535800
keras-214-30fe4ff1/optimizers.py,9109,8518,22,22,673,38.0825,462,17627,38082500
keras-214-30fe4ff1/optimizers_test.py,1880,1935,18,18,308,13.066,291,3815,13066000
keras-214-30fe4ff1/pretrained_word_embeddings.py,1324,1318,19,19,36,5.9512,443,2642,5951200
keras-214-30fe4ff1/recurrent.py,17170,17164,28,28,6,70.0124,490,34334,70012400
keras-214-30fe4ff1/saving.py,9656,9509,30,30,182,39.4168,486,19165,39416800
keras-214-30fe4ff1/tensorflow_backend.py,12022,25282,21,22,17406,145.6405,256,37304,145640500
keras-214-30fe4ff1/test_documentation.py,1945,1914,18,18,34,7.8237,493,3859,7823700
keras-214-30fe4ff1/test_tensorflow_integration.py,493,448,17,14,63,2.2131,425,941,2213100
keras-214-30fe4ff1/test_topology.py,10611,10621,18,18,107,44.1945,480,21232,44194500
keras-214-30fe4ff1/test_training.py,18663,18745,20,20,183,98.2767,380,37408,98276700
keras-214-30fe4ff1/test_vector_data_tasks.py,883,858,18,18,30,3.6831,472,1741,3683100
keras-214-30fe4ff1/theano_backend.py,24281,24281,24,24,1,72.8096,666,48562,72809600
keras-214-30fe4ff1/training.py,9981,9975,28,28,6,40.5044,492,19956,40504400
keras-214-30fe4ff1/training_arrays.py,4201,4201,21,21,3,12.6514,664,8402,12651400
keras-214-30fe4ff1/variational_autoencoder.py,1810,1813,18,18,4,7.439,487,3623,7439000
keras-214-30fe4ff1/wrappers_test.py,6039,6170,20,20,165,26.0691,468,12209,26069100
keras-214-30fe4ff1/__init__.py,7,7,6,6,0,0.0293,477,14,29300
keras-215-ed144aa1/autogen.py,4858,4858,21,21,2,15.5615,624,9716,15561500
keras-215-ed144aa1/backend_test.py,25399,25210,23,23,911,158.2717,319,50609,158271700
keras-215-ed144aa1/base_layer.py,7035,7041,32,32,6,28.5191,493,14076,28519100
keras-215-ed144aa1/callbacks.py,11228,8014,28,26,3219,40.382,476,19242,40382000
keras-215-ed144aa1/common.py,437,469,14,14,40,2.0084,451,906,2008400
keras-215-ed144aa1/constraints.py,979,970,18,18,21,4.6886,415,1949,4688600
keras-215-ed144aa1/convolutional_recurrent.py,7897,7952,28,28,76,33.1911,477,15849,33191100
keras-215-ed144aa1/data_utils_test.py,4588,4588,16,16,1,14.0402,653,9176,14040200
keras-215-ed144aa1/initializers.py,2524,2669,19,19,409,11.7509,441,5193,11750900
keras-215-ed144aa1/initializers_test.py,1758,1944,15,15,223,7.8813,469,3702,7881300
keras-215-ed144aa1/load_backend.py,905,912,20,20,12,3.8062,477,1817,3806200
keras-215-ed144aa1/multi_gpu_utils.py,1253,1219,23,23,49,5.486,450,2472,5486000
keras-215-ed144aa1/optimizers.py,8518,9109,22,22,708,38.2521,460,17627,38252100
keras-215-ed144aa1/optimizers_test.py,1935,1880,18,18,295,12.5941,302,3815,12594100
keras-215-ed144aa1/pretrained_word_embeddings.py,1318,1324,19,19,35,5.6252,469,2642,5625200
keras-215-ed144aa1/recurrent.py,17164,17170,28,28,6,69.7594,492,34334,69759400
keras-215-ed144aa1/saving.py,9509,9656,30,30,204,39.9264,480,19165,39926400
keras-215-ed144aa1/tensorflow_backend.py,25282,11980,22,21,15133,136.2811,273,37262,136281100
keras-215-ed144aa1/test_documentation.py,1914,1945,18,18,38,7.8289,492,3859,7828900
keras-215-ed144aa1/test_tensorflow_integration.py,448,493,14,17,70,2.2668,415,941,2266800
keras-215-ed144aa1/test_topology.py,10621,10611,18,18,113,44.4057,478,21232,44405700
keras-215-ed144aa1/test_training.py,18745,18663,20,20,170,98.9345,378,37408,98934500
keras-215-ed144aa1/test_vector_data_tasks.py,858,883,18,18,32,3.7577,463,1741,3757700
keras-215-ed144aa1/theano_backend.py,24281,24281,24,24,1,73.6174,659,48562,73617400
keras-215-ed144aa1/training.py,9975,9981,28,28,6,40.0348,498,19956,40034800
keras-215-ed144aa1/training_arrays.py,4201,4201,21,21,3,12.4765,673,8402,12476500
keras-215-ed144aa1/variational_autoencoder.py,1813,1810,18,18,4,7.412,488,3623,7412000
keras-215-ed144aa1/wrappers_test.py,6170,6039,20,20,143,25.7879,473,12209,25787900
keras-215-ed144aa1/__init__.py,7,7,6,6,0,0.0252,555,14,25200
keras-216-d5798e7a/convolutional_recurrent.py,7952,7903,28,28,60,32.281,491,15855,32281000
keras-216-d5798e7a/data_utils_test.py,4588,4588,16,16,1,13.8712,661,9176,13871200
keras-217-d7ea34fc/autogen.py,4858,4858,21,21,2,14.8071,656,9716,14807100
keras-217-d7ea34fc/backend_test.py,25210,25399,23,23,849,160.2301,315,50609,160230100
keras-217-d7ea34fc/base_layer.py,7041,7035,32,32,6,28.4835,494,14076,28483500
keras-217-d7ea34fc/callbacks.py,8014,11228,26,28,3776,46.1897,416,19242,46189700
keras-217-d7ea34fc/common.py,469,437,14,14,34,2.0849,434,906,2084900
keras-217-d7ea34fc/constraints.py,970,979,18,18,187,4.682,416,1949,4682000
keras-217-d7ea34fc/convolutional_recurrent.py,7903,7897,28,28,6,33.1409,476,15800,33140900
keras-217-d7ea34fc/initializers.py,2669,2524,19,19,155,11.9953,432,5193,11995300
keras-217-d7ea34fc/initializers_test.py,1944,1758,15,15,188,7.7043,480,3702,7704300
keras-217-d7ea34fc/load_backend.py,912,905,20,20,10,3.9453,460,1817,3945300
keras-217-d7ea34fc/multi_gpu_utils.py,1219,1253,23,23,64,5.8251,424,2472,5825100
keras-217-d7ea34fc/optimizers.py,9109,8518,22,22,681,41.0701,429,17627,41070100
keras-217-d7ea34fc/optimizers_test.py,1880,1935,18,18,309,12.7698,298,3815,12769800
keras-217-d7ea34fc/recurrent.py,17170,17164,28,28,6,69.4762,494,34334,69476200
keras-217-d7ea34fc/saving.py,9656,9509,30,30,182,39.0598,490,19165,39059800
keras-217-d7ea34fc/tensorflow_backend.py,11980,25282,21,22,17394,146.1079,255,37262,146107900
keras-217-d7ea34fc/test_documentation.py,1945,1914,18,18,34,8.6726,444,3859,8672600
keras-217-d7ea34fc/test_tensorflow_integration.py,493,448,17,14,63,2.535,371,941,2535000
keras-217-d7ea34fc/test_topology.py,10611,10621,18,18,107,44.5741,476,21232,44574100
keras-217-d7ea34fc/test_training.py,18663,18745,20,20,183,98.7178,378,37408,98717800
keras-217-d7ea34fc/test_vector_data_tasks.py,883,858,18,18,30,3.7097,469,1741,3709700
keras-217-d7ea34fc/theano_backend.py,24281,24281,24,24,1,75.0884,646,48562,75088400
keras-217-d7ea34fc/training.py,9981,9975,28,28,6,40.3125,495,19956,40312500
keras-217-d7ea34fc/training_arrays.py,4201,4201,21,21,3,13.0388,644,8402,13038800
keras-217-d7ea34fc/variational_autoencoder.py,1810,1813,18,18,4,7.6103,476,3623,7610300
keras-217-d7ea34fc/wrappers_test.py,6039,6170,20,20,165,26.0796,468,12209,26079600
keras-217-d7ea34fc/__init__.py,7,7,6,6,0,0.0285,491,14,28500
keras-218-2fadce57/variational_autoencoder.py,1813,1810,18,18,4,7.4293,487,3623,7429300
keras-219-7c7e51ea/cntk_backend.py,22627,22555,23,23,103,91.2974,494,45182,91297400
keras-219-7c7e51ea/tensorflow_backend.py,25282,25234,22,22,52,103.1495,489,50516,103149500
keras-219-7c7e51ea/theano_backend.py,24281,24233,24,24,52,97.9768,495,48514,97976800
keras-220-766e5f7a/test_training.py,18745,17939,20,20,862,83.6352,438,36684,83635200
keras-220-766e5f7a/training.py,9975,9492,28,28,622,41.997,463,19467,41997000
keras-220-766e5f7a/training_utils.py,4855,4530,26,26,333,33.5545,279,9385,33554500
keras-221-9e6b181b/initializers.py,2524,2516,19,19,38,10.6529,473,5040,10652900
keras-222-d789bd94/tensorflow_backend.py,25234,25128,22,22,118,102.3589,492,50362,102358900
keras-223-91efaaa1/backend_test.py,25399,25504,23,23,439,108.616,468,50903,108616000
keras-224-ad5db101/convolutional.py,11986,12038,23,23,250,59.5983,403,24024,59598300
keras-224-ad5db101/convolutional_test.py,10325,10193,20,20,137,42.6681,480,20518,42668100
keras-225-b23c9fe9/backend_test.py,25504,25562,23,23,66,104.9426,486,51066,104942600
keras-225-b23c9fe9/cntk_backend.py,22555,22555,23,23,0,67.8127,665,45110,67812700
keras-226-c3eb6276/lstm_text_generation.py,1153,1161,20,20,10,4.8858,473,2314,4885800
keras-227-ad578c4c/io_utils.py,3514,3119,23,23,420,21.8663,303,6633,21866300
keras-227-ad578c4c/io_utils_test.py,3092,2066,15,15,1035,16.2907,316,5158,16290700
keras-227-ad578c4c/network.py,10475,10475,30,30,1,31.4199,666,20950,31419900
keras-227-ad578c4c/saving.py,9509,9344,30,30,300,44.6521,422,18853,44652100
keras-227-ad578c4c/test_model_saving.py,10427,10494,18,18,474,48.3642,432,20921,48364200
keras-228-b8ec0e6d/backend_test.py,25562,25559,23,23,27,103.8668,492,51121,103866800
keras-228-b8ec0e6d/cntk_backend.py,22555,22555,23,23,0,69.9012,645,45110,69901200
keras-229-8202e627/backend_test.py,25559,25492,23,23,183,103.6205,492,51051,103620500
keras-230-960e7b53/backend_test.py,25492,25509,23,23,239,103.7799,491,51001,103779900
keras-230-960e7b53/cntk_backend.py,22555,22555,23,23,0,67.9817,663,45110,67981700
keras-230-960e7b53/tensorflow_backend.py,25128,25077,22,22,54,101.9138,492,50205,101913800
keras-230-960e7b53/theano_backend.py,24233,24106,24,24,130,102.5544,471,48339,102554400
keras-231-5d844095/backend_test.py,25509,25526,23,23,23,102.6945,496,51035,102694500
keras-232-f28ef61a/autogen.py,4858,4858,21,21,2,14.5755,666,9716,14575500
keras-232-f28ef61a/backend_test.py,25526,25387,23,23,1078,160.9053,316,50913,160905300
keras-232-f28ef61a/base_layer.py,7035,7041,32,32,6,28.681,490,14076,28681000
keras-232-f28ef61a/callbacks.py,11228,8014,28,26,3219,40.1923,478,19242,40192300
keras-232-f28ef61a/common.py,437,469,14,14,40,2.0126,450,906,2012600
keras-232-f28ef61a/constraints.py,979,970,18,18,21,4.5958,424,1949,4595800
keras-232-f28ef61a/convolutional_recurrent.py,7897,7903,28,28,6,32.3008,489,15800,32300800
keras-232-f28ef61a/initializers.py,2516,2661,19,19,409,12.0907,428,5177,12090700
keras-232-f28ef61a/initializers_test.py,1758,1944,15,15,223,8.1686,453,3702,8168600
keras-232-f28ef61a/load_backend.py,905,912,20,20,12,3.9599,458,1817,3959900
keras-232-f28ef61a/multi_gpu_utils.py,1253,1219,23,23,49,5.569,443,2472,5569000
keras-232-f28ef61a/optimizers.py,8518,9109,22,22,708,42.4545,415,17627,42454500
keras-232-f28ef61a/optimizers_test.py,1935,1880,18,18,297,13.4611,283,3815,13461100
keras-232-f28ef61a/recurrent.py,17164,17170,28,28,6,69.8806,491,34334,69880600
keras-232-f28ef61a/saving.py,9344,9491,30,30,204,38.8678,484,18835,38867800
keras-232-f28ef61a/tensorflow_backend.py,25077,11775,22,21,15150,133.8651,275,36852,133865100
keras-232-f28ef61a/test_documentation.py,1914,1945,18,18,38,8.1223,475,3859,8122300
keras-232-f28ef61a/test_tensorflow_integration.py,448,493,14,17,70,2.3346,403,941,2334600
keras-232-f28ef61a/test_topology.py,10621,10611,18,18,114,47.0549,451,21232,47054900
keras-232-f28ef61a/test_training.py,17939,17857,20,20,170,93.943,381,35796,93943000
keras-232-f28ef61a/test_vector_data_tasks.py,858,883,18,18,32,3.7271,467,1741,3727100
keras-232-f28ef61a/theano_backend.py,24106,24106,24,24,1,72.4867,665,48212,72486700
keras-232-f28ef61a/training.py,9492,9498,28,28,6,38.6415,491,18990,38641500
keras-232-f28ef61a/training_arrays.py,4201,4201,21,21,3,13.3514,629,8402,13351400
keras-232-f28ef61a/wrappers_test.py,6170,6039,20,20,145,25.844,472,12209,25844000
keras-232-f28ef61a/__init__.py,7,7,6,6,0,0.0266,526,14,26600
keras-233-78e1f57c/autogen.py,4858,4858,21,21,2,14.5121,669,9716,14512100
keras-233-78e1f57c/backend_test.py,25387,25574,23,23,860,159.7221,319,50961,159722100
keras-233-78e1f57c/base_layer.py,7041,7035,32,32,6,28.947,486,14076,28947000
keras-233-78e1f57c/callbacks.py,8014,11228,26,28,3776,47.6782,403,19242,47678200
keras-233-78e1f57c/common.py,469,437,14,14,34,2.1033,430,906,2103300
keras-233-78e1f57c/constraints.py,970,979,18,18,187,4.6544,418,1949,4654400
keras-233-78e1f57c/convolutional_recurrent.py,7903,7897,28,28,6,32.4316,487,15800,32431600
keras-233-78e1f57c/initializers.py,2661,2516,19,19,155,11.5363,448,5177,11536300
keras-233-78e1f57c/initializers_test.py,1944,1758,15,15,188,7.5266,491,3702,7526600
keras-233-78e1f57c/load_backend.py,912,905,20,20,10,3.8306,474,1817,3830600
keras-233-78e1f57c/multi_gpu_utils.py,1219,1253,23,23,64,5.498,449,2472,5498000
keras-233-78e1f57c/optimizers.py,9109,8518,22,22,674,37.6034,468,17627,37603400
keras-233-78e1f57c/optimizers_test.py,1880,1935,18,18,307,12.6879,300,3815,12687900
keras-233-78e1f57c/recurrent.py,17170,17164,28,28,6,70.5695,486,34334,70569500
keras-233-78e1f57c/saving.py,9491,9344,30,30,182,39.2665,479,18835,39266500
keras-233-78e1f57c/tensorflow_backend.py,11775,25077,21,22,17402,143.3134,257,36852,143313400
keras-233-78e1f57c/test_documentation.py,1945,1914,18,18,34,7.9331,486,3859,7933100
keras-233-78e1f57c/test_tensorflow_integration.py,493,448,17,14,63,2.1959,428,941,2195900
keras-233-78e1f57c/test_topology.py,10611,10621,18,18,107,44.0257,482,21232,44025700
keras-233-78e1f57c/test_training.py,17857,17939,20,20,183,94.9072,377,35796,94907200
keras-233-78e1f57c/test_vector_data_tasks.py,883,858,18,18,30,3.7649,462,1741,3764900
keras-233-78e1f57c/theano_backend.py,24106,24106,24,24,1,77.3262,623,48212,77326200
keras-233-78e1f57c/training.py,9498,9492,28,28,6,38.6246,491,18990,38624600
keras-233-78e1f57c/training_arrays.py,4201,4201,21,21,3,13.2325,634,8402,13232500
keras-233-78e1f57c/wrappers_test.py,6039,6170,20,20,165,27.3395,446,12209,27339500
keras-233-78e1f57c/__init__.py,7,7,6,6,0,0.0281,498,14,28100
keras-234-ce67a90d/backend_test.py,25574,25567,23,23,37,108.243,472,51141,108243000
keras-234-ce67a90d/theano_backend.py,24106,24019,24,24,90,99.8256,482,48125,99825600
keras-235-618edbe5/backend_test.py,25567,25564,23,23,223,111.1563,459,51131,111156300
keras-236-f6a30b00/backend_test.py,25564,25593,23,23,33,104.0676,491,51157,104067600
keras-236-f6a30b00/cntk_backend.py,22555,22555,23,23,0,68.596,657,45110,68596000
keras-237-bd024a1f/backend_test.py,25593,25601,23,23,95,114.304,447,51194,114304000
keras-237-bd024a1f/cntk_backend.py,22555,22497,23,23,84,99.2075,454,45052,99207500
keras-237-bd024a1f/numpy_backend.py,8918,8860,24,24,78,39.7321,447,17778,39732100
keras-237-bd024a1f/tensorflow_backend.py,25077,25019,22,22,92,109.4995,457,50096,109499500
keras-237-bd024a1f/theano_backend.py,24019,23961,24,24,86,108.8933,440,47980,108893300
keras-238-adaed1f8/backend_test.py,25601,25630,23,23,33,109.0847,469,51231,109084700
keras-239-0cccb83c/activations.py,697,697,20,20,1,2.3329,597,1394,2332900
keras-239-0cccb83c/autogen.py,4858,4858,21,21,2,14.8982,652,9716,14898200
keras-239-0cccb83c/backend_test.py,25630,25443,23,23,922,172.942,295,51073,172942000
keras-239-0cccb83c/base_layer.py,7035,7041,32,32,6,33.2941,422,14076,33294100
keras-239-0cccb83c/callbacks.py,11228,8014,28,26,3219,52.5337,366,19242,52533700
keras-239-0cccb83c/common.py,437,469,14,14,40,2.3131,391,906,2313100
keras-239-0cccb83c/constraints.py,979,970,18,18,21,5.3187,366,1949,5318700
keras-239-0cccb83c/convolutional_recurrent.py,7897,7903,28,28,6,38.7899,407,15800,38789900
keras-239-0cccb83c/initializers.py,2516,2661,19,19,409,12.1672,425,5177,12167200
keras-239-0cccb83c/initializers_test.py,1758,1944,15,15,223,8.3899,441,3702,8389900
keras-239-0cccb83c/load_backend.py,905,912,20,20,12,4.1103,442,1817,4110300
keras-239-0cccb83c/lstm_stateful.py,1026,1026,14,14,1,3.3176,618,2052,3317600
keras-239-0cccb83c/multi_gpu_utils.py,1253,1219,23,23,49,5.81,425,2472,5810000
keras-239-0cccb83c/network.py,10475,10475,30,30,2,32.2124,650,20950,32212400
keras-239-0cccb83c/optimizers.py,8518,9109,22,22,709,39.2475,449,17627,39247500
keras-239-0cccb83c/optimizers_test.py,1935,1880,18,18,296,13.1011,291,3815,13101100
keras-239-0cccb83c/recurrent.py,17164,17170,28,28,6,75.1008,457,34334,75100800
keras-239-0cccb83c/saving.py,9344,9491,30,30,204,43.0514,437,18835,43051400
keras-239-0cccb83c/tensorflow_backend.py,25019,11717,22,21,15101,136.7678,268,36736,136767800
keras-239-0cccb83c/test_documentation.py,1914,1945,18,18,38,8.4666,455,3859,8466600
keras-239-0cccb83c/test_tensorflow_integration.py,448,493,14,17,70,2.4267,387,941,2426700
keras-239-0cccb83c/test_topology.py,10621,10611,18,18,113,45.0443,471,21232,45044300
keras-239-0cccb83c/test_training.py,17939,17857,20,20,170,102.1955,350,35796,102195500
keras-239-0cccb83c/test_utils.py,2462,2462,20,20,1,8.1598,603,4924,8159800
keras-239-0cccb83c/test_vector_data_tasks.py,858,883,18,18,32,4.3199,403,1741,4319900
keras-239-0cccb83c/theano_backend.py,23961,23961,24,24,1,77.3311,619,47922,77331100
keras-239-0cccb83c/training.py,9492,9498,28,28,6,39.0029,486,18990,39002900
keras-239-0cccb83c/training_arrays.py,4201,4201,21,21,3,12.9268,649,8402,12926800
keras-239-0cccb83c/training_utils.py,4530,4530,26,26,1,14.5182,624,9060,14518200
keras-239-0cccb83c/vis_utils.py,1307,1307,26,26,1,4.1445,630,2614,4144500
keras-239-0cccb83c/wrappers_test.py,6170,6039,20,20,143,26.9382,453,12209,26938200
keras-239-0cccb83c/__init__.py,7,7,6,6,0,0.0267,524,14,26700
keras-240-e8ec47aa/tensorflow_backend.py,11717,11776,21,21,56,50.5702,464,23493,50570200
keras-241-d3ab82cf/tensorflow_backend.py,11776,11776,21,21,0,36.6677,642,23552,36667700
keras-241-d3ab82cf/training.py,9498,9498,28,28,0,28.5767,664,18996,28576700
keras-241-d3ab82cf/training_arrays.py,4201,4210,21,21,14,17.1438,490,8411,17143800
keras-242-05637cf2/backend_test.py,25443,25379,23,23,87,103.986,488,50822,103986000
keras-243-b1fbc247/backend_test.py,25379,25382,23,23,3,111.6872,454,50761,111687200
keras-243-b1fbc247/tensorflow_backend.py,11776,11776,21,21,1,38.0524,618,23552,38052400
keras-244-8e23a3ec/activations.py,697,697,20,20,4,2.2828,610,1394,2282800
keras-244-8e23a3ec/backend_test.py,25382,25609,23,23,849,138.9574,366,50991,138957400
keras-244-8e23a3ec/cifar10_cnn_capsule.py,1640,1687,18,18,281,11.0718,300,3327,11071800
keras-244-8e23a3ec/cntk_backend.py,22497,22513,23,23,22,112.5661,399,45010,112566100
keras-244-8e23a3ec/convolutional.py,12038,12038,23,23,2,37.8545,636,24076,37854500
keras-244-8e23a3ec/numpy_backend.py,8860,8777,24,24,85,39.0071,452,17637,39007100
keras-244-8e23a3ec/optimizers.py,9109,9109,22,22,1,29.9809,607,18218,29980900
keras-244-8e23a3ec/saving.py,9491,9455,30,30,81,44.1963,428,18946,44196300
keras-244-8e23a3ec/tensorflow_backend.py,11776,11629,21,21,154,48.2557,485,23405,48255700
keras-244-8e23a3ec/test_model_saving.py,10494,10468,18,18,28,42.5179,493,20962,42517900
keras-244-8e23a3ec/theano_backend.py,23961,24112,24,24,354,113.1341,424,48073,113134100
keras-245-9bd69784/activations.py,697,697,20,20,4,2.3128,602,1394,2312800
keras-245-9bd69784/autogen.py,4858,4858,21,21,2,15.6933,619,9716,15693300
keras-245-9bd69784/backend_test.py,25609,25630,23,23,1302,165.2287,310,51239,165228700
keras-245-9bd69784/base_layer.py,7041,7035,32,32,6,28.7803,489,14076,28780300
keras-245-9bd69784/callbacks.py,8014,11228,26,28,3776,45.5614,422,19242,45561400
keras-245-9bd69784/cifar10_cnn_capsule.py,1687,1640,18,18,260,10.4634,317,3327,10463400
keras-245-9bd69784/cntk_backend.py,22513,22497,23,23,22,108.4222,415,45010,108422200
keras-245-9bd69784/common.py,469,437,14,14,34,1.9368,467,906,1936800
keras-245-9bd69784/constraints.py,970,979,18,18,187,4.5805,425,1949,4580500
keras-245-9bd69784/convolutional.py,12038,12038,23,23,2,35.9074,670,24076,35907400
keras-245-9bd69784/convolutional_recurrent.py,7903,7897,28,28,6,31.9692,494,15800,31969200
keras-245-9bd69784/initializers.py,2661,2516,19,19,155,11.7198,441,5177,11719800
keras-245-9bd69784/initializers_test.py,1944,1758,15,15,188,7.5352,491,3702,7535200
keras-245-9bd69784/load_backend.py,912,905,20,20,10,3.8337,473,1817,3833700
keras-245-9bd69784/multi_gpu_utils.py,1219,1253,23,23,64,5.4371,454,2472,5437100
keras-245-9bd69784/numpy_backend.py,8777,8860,24,24,102,36.2388,486,17637,36238800
keras-245-9bd69784/optimizers.py,9109,8518,22,22,674,39.2039,449,17627,39203900
keras-245-9bd69784/optimizers_test.py,1880,1935,18,18,309,13.5873,280,3815,13587300
keras-245-9bd69784/recurrent.py,17170,17164,28,28,6,69.7651,492,34334,69765100
keras-245-9bd69784/saving.py,9455,9344,30,30,150,42.0501,447,18799,42050100
keras-245-9bd69784/tensorflow_backend.py,11629,25019,21,22,17525,143.1217,256,36648,143121700
keras-245-9bd69784/test_documentation.py,1945,1914,18,18,34,8.1453,473,3859,8145300
keras-245-9bd69784/test_model_saving.py,10468,10494,18,18,33,44.0567,475,20962,44056700
keras-245-9bd69784/test_tensorflow_integration.py,493,448,17,14,63,2.4327,386,941,2432700
keras-245-9bd69784/test_topology.py,10611,10621,18,18,107,43.9052,483,21232,43905200
keras-245-9bd69784/test_training.py,17857,17939,20,20,183,94.1896,380,35796,94189600
keras-245-9bd69784/test_vector_data_tasks.py,883,858,18,18,30,3.6951,471,1741,3695100
keras-245-9bd69784/theano_backend.py,24112,23961,24,24,342,112.4702,427,48073,112470200
keras-245-9bd69784/training.py,9498,9492,28,28,6,39.1472,485,18990,39147200
keras-245-9bd69784/training_arrays.py,4210,4201,21,21,14,16.9926,494,8411,16992600
keras-245-9bd69784/wrappers_test.py,6039,6170,20,20,165,26.0435,468,12209,26043500
keras-245-9bd69784/__init__.py,7,7,6,6,0,0.0252,555,14,25200
keras-246-86cb6b60/convolutional.py,12038,12038,23,23,2,36.0088,668,24076,36008800
keras-247-f0eb8d53/cntk_backend.py,22497,22513,23,23,20,91.4161,492,45010,91416100
keras-248-28ee86a5/cifar10_cnn_capsule.py,1640,1687,18,18,277,10.5343,315,3327,10534300
keras-250-f0a24a00/activations.py,697,697,20,20,4,2.2742,612,1394,2274200
keras-252-c82fe8a1/test_model_saving.py,10494,10468,18,18,28,41.7235,502,20962,41723500
keras-254-d7c0e952/saving.py,9344,9308,30,30,81,43.4933,428,18652,43493300
keras-255-dc83851a/backend_test.py,25630,25936,23,23,636,117.5236,438,51566,117523600
keras-255-dc83851a/numpy_backend.py,8860,8860,24,24,1,27.7613,638,17720,27761300
keras-256-c24d16af/backend_test.py,25936,25914,23,23,101,107.7791,481,51850,107779100
keras-256-c24d16af/cntk_backend.py,22513,22513,23,23,4,100.9691,445,45026,100969100
keras-256-c24d16af/tensorflow_backend.py,25019,24872,22,22,155,105.9832,470,49891,105983200
keras-256-c24d16af/theano_backend.py,23961,24112,24,24,353,120.435,399,48073,120435000
keras-257-2f55055a/backend_test.py,25914,25896,23,23,39,110.2431,469,51810,110243100
keras-257-2f55055a/numpy_backend.py,8860,8777,24,24,85,38.0584,463,17637,38058400
keras-258-b4e01aee/optimizers.py,8518,8518,22,22,1,27.2717,624,17036,27271700
keras-259-331d5b01/autogen.py,4858,4858,21,21,2,15.3718,632,9716,15371800
keras-259-331d5b01/backend_test.py,25896,25883,23,23,225,142.7436,362,51779,142743600
keras-259-331d5b01/base_layer.py,7035,7041,32,32,6,29.8803,471,14076,29880300
keras-259-331d5b01/callbacks.py,11228,8014,28,26,3219,42.0072,458,19242,42007200
keras-259-331d5b01/cntk_backend.py,22513,22513,23,23,0,72.4932,621,45026,72493200
keras-259-331d5b01/common.py,437,469,14,14,40,2.2728,398,906,2272800
keras-259-331d5b01/constraints.py,979,970,18,18,21,5.2063,374,1949,5206300
keras-259-331d5b01/convolutional_recurrent.py,7897,7903,28,28,6,36.7328,430,15800,36732800
keras-259-331d5b01/load_backend.py,905,912,20,20,12,4.0175,452,1817,4017500
keras-259-331d5b01/multi_gpu_utils.py,1253,1219,23,23,49,5.6433,438,2472,5643300
keras-259-331d5b01/numpy_backend.py,8777,8777,24,24,1,27.604,635,17554,27604000
keras-259-331d5b01/optimizers.py,8518,9109,22,22,710,40.4324,435,17627,40432400
keras-259-331d5b01/optimizers_test.py,1935,1880,18,18,295,13.3125,286,3815,13312500
keras-259-331d5b01/recurrent.py,17164,17170,28,28,6,71.2159,482,34334,71215900
keras-259-331d5b01/saving.py,9308,9455,30,30,204,40.2356,466,18763,40235600
keras-259-331d5b01/tensorflow_backend.py,24872,20738,22,23,7454,158.4856,287,45610,158485600
keras-259-331d5b01/test_documentation.py,1914,1945,18,18,38,8.1427,473,3859,8142700
keras-259-331d5b01/test_tensorflow_integration.py,448,493,14,17,70,2.351,400,941,2351000
keras-259-331d5b01/test_topology.py,10621,10611,18,18,115,45.3066,468,21232,45306600
keras-259-331d5b01/test_training.py,17939,17857,20,20,170,98.6815,362,35796,98681500
keras-259-331d5b01/test_vector_data_tasks.py,858,883,18,18,32,4.0363,431,1741,4036300
keras-259-331d5b01/training.py,9492,9498,28,28,6,42.4014,447,18990,42401400
keras-259-331d5b01/training_arrays.py,4201,4210,21,21,17,18.024,466,8411,18024000
keras-259-331d5b01/wrappers_test.py,6170,6039,20,20,144,26.819,455,12209,26819000
keras-259-331d5b01/__init__.py,7,7,6,6,0,0.0275,509,14,27500
keras-260-ea1acc11/backend_test.py,25883,25855,23,23,32,107.9192,479,51738,107919200
keras-260-ea1acc11/callbacks.py,8014,8014,26,26,0,24.2206,661,16028,24220600
keras-260-ea1acc11/optimizers.py,9109,9109,22,22,0,29.2125,623,18218,29212500
keras-260-ea1acc11/tensorboard_v1.py,3260,3260,28,28,0,10.419,625,6520,10419000
keras-260-ea1acc11/tensorboard_v2.py,277,277,13,13,0,0.8952,618,554,895200
keras-261-5b653e25/cntk_backend.py,22513,22592,23,23,117,96.0432,469,45105,96043200
keras-261-5b653e25/test_topology.py,10611,10624,18,18,18,44.1614,480,21235,44161400
keras-261-5b653e25/training.py,9498,9498,28,28,1,29.5858,642,18996,29585800
keras-262-029461c7/autogen.py,4858,4858,21,21,2,15.4133,630,9716,15413300
keras-262-029461c7/backend_test.py,25855,25857,23,23,84,145.633,355,51712,145633000
keras-262-029461c7/base_layer.py,7041,7035,32,32,6,31.1197,452,14076,31119700
keras-262-029461c7/callbacks.py,8014,11228,26,28,3776,49.7301,386,19242,49730100
keras-262-029461c7/cntk_backend.py,22592,22513,23,23,105,98.7014,456,45105,98701400
keras-262-029461c7/common.py,469,437,14,14,34,2.1662,418,906,2166200
keras-262-029461c7/constraints.py,970,979,18,18,187,5.0236,387,1949,5023600
keras-262-029461c7/convolutional_recurrent.py,7903,7897,28,28,6,38.3444,412,15800,38344400
keras-262-029461c7/load_backend.py,912,905,20,20,10,4.1596,436,1817,4159600
keras-262-029461c7/multi_gpu_utils.py,1219,1253,23,23,64,5.7322,431,2472,5732200
keras-262-029461c7/numpy_backend.py,8777,8777,24,24,1,27.2217,644,17554,27221700
keras-262-029461c7/optimizers.py,9109,8518,22,22,676,39.5343,445,17627,39534300
keras-262-029461c7/optimizers_test.py,1880,1935,18,18,308,13.9291,273,3815,13929100
keras-262-029461c7/recurrent.py,17170,17164,28,28,6,73.35,468,34334,73350000
keras-262-029461c7/saving.py,9455,9308,30,30,182,39.8763,470,18763,39876300
keras-262-029461c7/tensorflow_backend.py,20738,24872,23,22,7680,165.7991,275,45610,165799100
keras-262-029461c7/test_documentation.py,1945,1914,18,18,34,8.0119,481,3859,8011900
keras-262-029461c7/test_tensorflow_integration.py,493,448,17,14,63,2.4766,379,941,2476600
keras-262-029461c7/test_topology.py,10624,10621,18,18,120,52.6381,403,21245,52638100
keras-262-029461c7/test_training.py,17857,17939,20,20,183,96.3433,371,35796,96343300
keras-262-029461c7/test_vector_data_tasks.py,883,858,18,18,30,3.9333,442,1741,3933300
keras-262-029461c7/training.py,9498,9492,28,28,7,41.3542,459,18990,41354200
keras-262-029461c7/training_arrays.py,4210,4201,21,21,14,17.9844,467,8411,17984400
keras-262-029461c7/wrappers_test.py,6039,6170,20,20,165,27.0324,451,12209,27032400
keras-262-029461c7/__init__.py,7,7,6,6,0,0.0271,516,14,27100
keras-263-7dd8545a/cntk_backend.py,22513,22592,23,23,117,94.7151,476,45105,94715100
keras-264-435cf42e/test_topology.py,10621,10634,18,18,18,46.4189,457,21255,46418900
keras-265-8240ef77/autogen.py,4858,4858,21,21,2,15.2179,638,9716,15217900
keras-265-8240ef77/backend_test.py,25857,25895,23,23,56,112.2285,461,51752,112228500
keras-265-8240ef77/base_layer.py,7035,7041,32,32,6,30.2381,465,14076,30238100
keras-265-8240ef77/callbacks.py,11228,8014,28,26,3219,43.3465,443,19242,43346500
keras-265-8240ef77/common.py,437,469,14,14,40,2.1317,425,906,2131700
keras-265-8240ef77/constraints.py,979,970,18,18,21,5.8781,331,1949,5878100
keras-265-8240ef77/convolutional_recurrent.py,7897,7903,28,28,6,34.1442,462,15800,34144200
keras-265-8240ef77/convolutional_recurrent_test.py,1511,1518,16,16,7,6.4529,469,3029,6452900
keras-265-8240ef77/load_backend.py,905,912,20,20,12,4.2243,430,1817,4224300
keras-265-8240ef77/multi_gpu_utils.py,1253,1219,23,23,49,5.8729,420,2472,5872900
keras-265-8240ef77/optimizers.py,8518,9109,22,22,708,42.303,416,17627,42303000
keras-265-8240ef77/optimizers_test.py,1935,1880,18,18,296,14.7173,259,3815,14717300
keras-265-8240ef77/recurrent.py,17164,17170,28,28,6,71.6031,479,34334,71603100
keras-265-8240ef77/saving.py,9308,9455,30,30,204,40.0111,468,18763,40011100
keras-265-8240ef77/tensorflow_backend.py,24872,20682,22,23,7478,162.6696,280,45554,162669600
keras-265-8240ef77/test_documentation.py,1914,1945,18,18,38,8.5457,451,3859,8545700
keras-265-8240ef77/test_tensorflow_integration.py,448,493,14,17,70,2.533,371,941,2533000
keras-265-8240ef77/test_topology.py,10634,10624,18,18,115,45.9402,462,21258,45940200
keras-265-8240ef77/test_training.py,17939,17857,20,20,169,96.047,372,35796,96047000
keras-265-8240ef77/test_vector_data_tasks.py,858,883,18,18,32,3.9911,436,1741,3991100
keras-265-8240ef77/training.py,9492,9498,28,28,7,39.6331,479,18990,39633100
keras-265-8240ef77/training_arrays.py,4201,4210,21,21,17,17.9172,469,8411,17917200
keras-265-8240ef77/wrappers_test.py,6170,6039,20,20,145,26.7996,455,12209,26799600
keras-265-8240ef77/__init__.py,7,7,6,6,0,0.0271,516,14,27100
keras-266-a7eff2f2/backend_test.py,25895,25898,23,23,6,106.0942,488,51793,106094200
keras-266-a7eff2f2/load_backend.py,912,912,20,20,1,2.9203,624,1824,2920300
keras-266-a7eff2f2/optimizers.py,9109,9120,22,22,28,37.8046,482,18229,37804600
keras-266-a7eff2f2/tensorflow_backend.py,20682,20536,23,23,248,91.1912,451,41218,91191200
keras-266-a7eff2f2/test_documentation.py,1945,1914,18,18,34,8.1517,473,3859,8151700
keras-267-995f1e70/lstm_text_generation.py,1161,1161,20,20,1,3.7559,618,2322,3755900
keras-267-995f1e70/mnist_acgan.py,3024,3024,22,22,1,9.5581,632,6048,9558100
keras-267-995f1e70/optimizers.py,9120,9120,22,22,2,28.692,635,18240,28692000
keras-268-7c5057b4/callbacks.py,8014,11228,26,28,3776,46.8642,410,19242,46864200
keras-269-c6428ee0/wrappers_test.py,6039,6158,20,20,141,26.0166,468,12197,26016600
keras-270-286a208c/tensorflow_backend.py,20536,20550,23,23,48,86.2799,476,41086,86279900
keras-271-408a344e/autogen.py,4858,4858,21,21,2,15.5211,625,9716,15521100
keras-271-408a344e/saving.py,9455,9455,30,30,1,30.3202,623,18910,30320200
keras-271-408a344e/tensorflow_backend.py,20550,20547,23,23,9,86.9142,472,41097,86914200
keras-272-a41ccecf/autogen.py,4858,4858,21,21,2,15.6297,621,9716,15629700
keras-272-a41ccecf/multi_gpu_utils.py,1219,1253,23,23,64,5.6944,434,2472,5694400
keras-272-a41ccecf/saving.py,9455,9455,30,30,1,29.4465,642,18910,29446500
keras-272-a41ccecf/tensorflow_backend.py,20547,20550,23,23,9,87.1437,471,41097,87143700
keras-273-2fbcf344/saving.py,9455,9455,30,30,1,30.2543,625,18910,30254300
keras-274-7e5d34f2/saving.py,9455,9455,30,30,1,29.6695,637,18910,29669500
keras-275-c8b0e33c/autogen.py,4858,4858,21,21,2,15.4006,630,9716,15400600
keras-275-c8b0e33c/tensorflow_backend.py,20550,20547,23,23,9,93.2938,440,41097,93293800
keras-276-820251a0/autogen.py,4858,4858,21,21,2,17.1978,564,9716,17197800
keras-276-820251a0/optimizers.py,9120,8782,22,22,414,41.1786,434,17902,41178600
keras-276-820251a0/optimizers_test.py,1880,1690,18,18,200,8.411,424,3570,8411000
keras-276-820251a0/saving.py,9455,9308,30,30,182,39.5192,474,18763,39519200
keras-276-820251a0/tensorflow_backend.py,20547,20550,23,23,9,85.6138,480,41097,85613800
keras-277-91765e70/autogen.py,4858,4858,21,21,2,15.1616,640,9716,15161600
keras-277-91765e70/backend_test.py,25898,25857,23,23,49,111.3914,464,51755,111391400
keras-277-91765e70/base_layer.py,7041,7035,32,32,6,29.3896,478,14076,29389600
keras-277-91765e70/callbacks.py,11228,11228,28,28,3,34.7571,646,22456,34757100
keras-277-91765e70/common.py,469,437,14,14,34,1.9866,456,906,1986600
keras-277-91765e70/constraints.py,970,979,18,18,187,4.9955,390,1949,4995500
keras-277-91765e70/convolutional_recurrent.py,7903,7897,28,28,6,32.8888,480,15800,32888800
keras-277-91765e70/convolutional_recurrent_test.py,1518,1511,16,16,7,6.2839,482,3029,6283900
keras-277-91765e70/load_backend.py,912,905,20,20,9,3.9567,459,1817,3956700
keras-277-91765e70/lstm_text_generation.py,1161,1161,20,20,1,3.6585,634,2322,3658500
keras-277-91765e70/mnist_acgan.py,3024,3024,22,22,1,9.4581,639,6048,9458100
keras-277-91765e70/optimizers.py,8782,8518,22,22,278,39.3303,439,17300,39330300
keras-277-91765e70/optimizers_test.py,1690,1935,18,18,367,9.8083,369,3625,9808300
keras-277-91765e70/recurrent.py,17170,17164,28,28,6,70.7552,485,34334,70755200
keras-277-91765e70/tensorflow_backend.py,20550,24872,23,22,7809,170.1793,266,45422,170179300
keras-277-91765e70/test_tensorflow_integration.py,493,448,17,14,63,2.367,397,941,2367000
keras-277-91765e70/test_topology.py,10624,10634,18,18,109,47.4781,447,21258,47478100
keras-277-91765e70/test_training.py,17857,17939,20,20,183,97.7161,366,35796,97716100
keras-277-91765e70/test_vector_data_tasks.py,883,858,18,18,30,4.0813,426,1741,4081300
keras-277-91765e70/training.py,9498,9492,28,28,6,41.4492,458,18990,41449200
keras-277-91765e70/training_arrays.py,4210,4201,21,21,14,18.3388,458,8411,18338800
keras-277-91765e70/wrappers_test.py,6158,6170,20,20,16,27.9477,441,12328,27947700
keras-277-91765e70/__init__.py,7,7,6,6,0,0.0281,498,14,28100
keras-278-ed387f12/backend_test.py,25857,25898,23,23,55,117.5665,440,51755,117566500
keras-278-ed387f12/base_layer.py,7035,7041,32,32,6,29.7167,473,14076,29716700
keras-278-ed387f12/callbacks.py,11228,11228,28,28,3,34.7407,646,22456,34740700
keras-278-ed387f12/common.py,437,469,14,14,40,2.0472,442,906,2047200
keras-278-ed387f12/constraints.py,979,970,18,18,21,4.688,415,1949,4688000
keras-278-ed387f12/convolutional_recurrent.py,7897,7903,28,28,6,32.5253,485,15800,32525300
keras-278-ed387f12/convolutional_recurrent_test.py,1511,1518,16,16,7,6.3761,475,3029,6376100
keras-278-ed387f12/load_backend.py,905,912,20,20,11,4.1075,442,1817,4107500
keras-278-ed387f12/lstm_text_generation.py,1161,1161,20,20,1,3.614,642,2322,3614000
keras-278-ed387f12/mnist_acgan.py,3024,3024,22,22,1,9.456,639,6048,9456000
keras-278-ed387f12/optimizers.py,8518,8782,22,22,288,37.169,465,17300,37169000
keras-278-ed387f12/optimizers_test.py,1935,1690,18,18,318,8.9505,405,3625,8950500
keras-278-ed387f12/recurrent.py,17164,17170,28,28,6,71.7882,478,34334,71788200
keras-278-ed387f12/tensorflow_backend.py,24872,20547,22,23,7469,156.026,291,45419,156026000
keras-278-ed387f12/test_tensorflow_integration.py,448,493,14,17,70,2.3451,401,941,2345100
keras-278-ed387f12/test_topology.py,10634,10624,18,18,114,46.1953,460,21258,46195300
keras-278-ed387f12/test_training.py,17939,17857,20,20,170,104.0349,344,35796,104034900
keras-278-ed387f12/test_vector_data_tasks.py,858,883,18,18,32,3.8691,449,1741,3869100
keras-278-ed387f12/training.py,9492,9498,28,28,6,39.3784,482,18990,39378400
keras-278-ed387f12/training_arrays.py,4201,4210,21,21,17,17.6512,476,8411,17651200
keras-278-ed387f12/wrappers_test.py,6170,6158,20,20,16,26.3288,468,12328,26328800
keras-278-ed387f12/__init__.py,7,7,6,6,0,0.0267,524,14,26700
keras-279-4b9d1699/backend_test.py,25898,25890,23,23,8,109.6246,472,51788,109624600
keras-279-4b9d1699/convolutional_recurrent_test.py,1518,1550,16,16,36,6.8057,450,3068,6805700
keras-280-255caadf/backend_test.py,25890,25873,23,23,19,110.2147,469,51763,110214700
keras-280-255caadf/tensorflow_backend.py,20547,20488,23,23,198,111.69,367,41035,111690000
keras-280-255caadf/test_topology.py,10624,10634,18,18,109,47.5646,446,21258,47564600
keras-280-255caadf/test_training.py,17857,17934,20,20,119,87.8267,407,35791,87826700
keras-280-255caadf/wrappers_test.py,6158,6170,20,20,16,26.518,464,12328,26518000
keras-284-14625e57/backend_test.py,25873,25857,23,23,23,108.6815,475,51730,108681500
keras-284-14625e57/base_layer.py,7041,7035,32,32,6,29.6254,475,14076,29625400
keras-284-14625e57/callbacks.py,11228,11228,28,28,3,34.2463,655,22456,34246300
keras-284-14625e57/common.py,469,437,14,14,34,2.0427,443,906,2042700
keras-284-14625e57/constraints.py,970,979,18,18,187,4.7131,413,1949,4713100
keras-284-14625e57/convolutional_recurrent.py,7903,7897,28,28,6,33.2436,475,15800,33243600
keras-284-14625e57/convolutional_recurrent_test.py,1550,1511,16,16,39,6.5953,464,3061,6595300
keras-284-14625e57/load_backend.py,912,905,20,20,9,3.8868,467,1817,3886800
keras-284-14625e57/lstm_text_generation.py,1161,1161,20,20,1,3.6514,635,2322,3651400
keras-284-14625e57/mnist_acgan.py,3024,3024,22,22,1,9.4547,639,6048,9454700
keras-284-14625e57/optimizers.py,8782,8518,22,22,276,37.1441,465,17300,37144100
keras-284-14625e57/optimizers_test.py,1690,1935,18,18,367,9.4849,382,3625,9484900
keras-284-14625e57/recurrent.py,17170,17164,28,28,6,73.53,466,34334,73530000
keras-284-14625e57/tensorflow_backend.py,20488,24872,23,22,7650,163.6579,277,45360,163657900
keras-284-14625e57/test_tensorflow_integration.py,493,448,17,14,63,2.8803,326,941,2880300
keras-284-14625e57/test_training.py,17934,17939,20,20,9,75.1854,477,35873,75185400
keras-284-14625e57/test_vector_data_tasks.py,883,858,18,18,30,3.996,435,1741,3996000
keras-284-14625e57/training.py,9498,9492,28,28,6,39.6512,478,18990,39651200
keras-284-14625e57/training_arrays.py,4210,4201,21,21,14,17.4352,482,8411,17435200
keras-284-14625e57/__init__.py,7,7,6,6,0,0.0279,501,14,27900
keras-285-0ca37c98/backend_test.py,25857,25873,23,23,24,111.8575,462,51730,111857500
keras-285-0ca37c98/base_layer.py,7035,7041,32,32,6,30.6083,459,14076,30608300
keras-285-0ca37c98/callbacks.py,11228,11228,28,28,3,35.6877,629,22456,35687700
keras-285-0ca37c98/common.py,437,469,14,14,40,2.4309,372,906,2430900
keras-285-0ca37c98/constraints.py,979,970,18,18,21,5.1114,381,1949,5111400
keras-285-0ca37c98/load_backend.py,905,912,20,20,11,3.853,471,1817,3853000
keras-285-0ca37c98/lstm_text_generation.py,1161,1161,20,20,1,3.5917,646,2322,3591700
keras-285-0ca37c98/mnist_acgan.py,3024,3024,22,22,1,9.3854,644,6048,9385400
keras-285-0ca37c98/optimizers.py,8518,8782,22,22,286,38.3332,451,17300,38333200
keras-285-0ca37c98/optimizers_test.py,1935,1690,18,18,318,9.0951,398,3625,9095100
keras-285-0ca37c98/recurrent.py,17164,17170,28,28,6,74.5987,460,34334,74598700
keras-285-0ca37c98/tensorflow_backend.py,24872,22133,22,23,6314,156.1828,300,47005,156182800
keras-285-0ca37c98/test_tensorflow_integration.py,448,493,14,17,70,2.5892,363,941,2589200
keras-285-0ca37c98/test_vector_data_tasks.py,858,883,18,18,32,4.0573,429,1741,4057300
keras-285-0ca37c98/training.py,9492,9492,28,28,0,29.5452,642,18984,29545200
keras-285-0ca37c98/training_arrays.py,4201,4210,21,21,17,18.517,454,8411,18517000
keras-285-0ca37c98/__init__.py,7,7,6,6,0,0.0276,507,14,27600
keras-286-c4d29cdf/callbacks.py,11228,11228,28,28,3,35.5561,631,22456,35556100
keras-286-c4d29cdf/tensorflow_backend.py,22133,21810,23,22,555,129.4932,339,43943,129493200
keras-287-8cc7a975/backend_test.py,25873,25857,23,23,23,107.8261,479,51730,107826100
keras-287-8cc7a975/constraints.py,970,979,18,18,187,4.7097,413,1949,4709700
keras-287-8cc7a975/optimizers_test.py,1690,1935,18,18,367,8.948,405,3625,8948000
keras-287-8cc7a975/tensorflow_backend.py,21810,21683,22,22,299,114.9832,378,43493,114983200
keras-288-4d857be6/tensorflow_backend.py,21683,19731,22,22,1983,91.3082,453,41414,91308200
keras-289-bbba9ced/base_layer.py,7041,7035,32,32,6,28.9698,485,14076,28969800
keras-289-bbba9ced/common.py,469,437,14,14,34,1.9862,456,906,1986200
keras-289-bbba9ced/load_backend.py,912,905,20,20,9,3.9054,465,1817,3905400
keras-289-bbba9ced/optimizers.py,8782,8534,22,22,269,37.0722,467,17316,37072200
keras-289-bbba9ced/recurrent.py,17170,17164,28,28,6,71.6194,479,34334,71619400
keras-289-bbba9ced/tensorflow_backend.py,19731,21074,22,22,3350,121.9732,334,40805,121973200
keras-289-bbba9ced/test_tensorflow_integration.py,493,448,17,14,63,2.3211,405,941,2321100
keras-289-bbba9ced/training.py,9492,9492,28,28,0,29.2445,649,18984,29244500
keras-289-bbba9ced/training_arrays.py,4210,4201,21,21,14,17.8202,471,8411,17820200
keras-289-bbba9ced/__init__.py,7,7,6,6,0,0.0284,492,14,28400
keras-290-17eab763/tensorflow_backend.py,21074,21784,22,22,982,122.4164,350,42858,122416400
keras-291-7c84229f/tensorflow_backend.py,21784,22114,22,22,647,111.8614,392,43898,111861400
keras-291-7c84229f/test_vector_data_tasks.py,883,858,18,18,30,3.8474,452,1741,3847400
keras-292-f4b5c496/optimizers.py,8534,8518,22,22,18,35.5689,479,17052,35568900
keras-292-f4b5c496/tensorflow_backend.py,22114,24872,22,22,5008,151.9971,309,46986,151997100
keras-293-7ff44331/autogen.py,4858,4864,21,21,8,21.6673,448,9722,21667300
keras-295-2944988b/tensorflow_backend.py,24872,24836,22,22,42,103.887,478,49708,103887000
keras-296-050e8cb7/backend_test.py,25857,25728,23,23,129,106.9993,482,51585,106999300
keras-296-050e8cb7/tensorflow_backend.py,24836,24831,22,22,7,102.7842,483,49667,102784200
keras-297-d48e9707/common.py,437,431,14,14,8,1.9741,439,868,1974100
keras-298-f6994685/lstm_stateful.py,1026,1026,14,14,1,3.2575,629,2052,3257500
keras-299-63320f80/cntk_backend.py,22592,22556,23,23,61,94.007,480,45148,94007000
keras-300-6c92fa42/backend_test.py,25728,25349,23,23,381,108.8929,469,51077,108892900
keras-300-6c92fa42/cntk_backend.py,22556,22556,23,23,0,72.0572,626,45112,72057200
keras-300-6c92fa42/numpy_backend.py,8777,8771,24,24,6,38.3334,457,17548,38333400
keras-300-6c92fa42/tensorflow_backend.py,24831,24837,22,22,21,102.4063,485,49668,102406300
keras-300-6c92fa42/theano_backend.py,24112,24112,24,24,0,74.2164,649,48224,74216400
keras-301-91ccb284/convolutional_recurrent_test.py,1511,1481,16,20,65,7.5405,396,2992,7540500
keras-302-7dd1c00e/boston_housing.py,400,399,16,16,12,1.8771,425,799,1877100
keras-302-7dd1c00e/imdb.py,927,929,17,17,25,4.2009,441,1856,4200900
keras-302-7dd1c00e/initializers.py,2516,2504,19,19,28,10.8948,460,5020,10894800
keras-302-7dd1c00e/initializers_test.py,1758,1632,15,15,128,7.3773,459,3390,7377300
keras-302-7dd1c00e/reuters.py,777,776,16,16,12,3.6192,429,1553,3619200
keras-304-780b74df/autogen.py,4864,4883,21,21,23,21.409,455,9747,21409000
keras-304-780b74df/test_doc_auto_generation.py,507,337,15,12,172,1.8767,449,844,1876700
keras-305-71aadf5e/backend_test.py,25349,25288,23,23,63,104.7847,483,50637,104784700
keras-305-71aadf5e/cntk_backend.py,22556,22556,23,23,0,69.5668,648,45112,69566800
keras-306-7ab5d561/mnist_siamese.py,921,921,17,17,2,2.8837,638,1842,2883700
keras-308-979e880c/cntk_backend.py,22556,22604,23,23,94,94.3447,478,45160,94344700
keras-309-29b80082/lstm_seq2seq.py,1698,1698,18,18,1,5.2045,652,3396,5204500
keras-309-29b80082/lstm_seq2seq_restore.py,1371,1371,16,16,1,4.3457,630,2742,4345700
keras-311-a7fdfdf2/imdb_lstm.py,75,75,8,8,1,0.2631,570,150,263100
keras-312-555d2124/imdb_fasttext.py,327,327,19,19,1,1.0708,610,654,1070800
keras-314-4c16931b/deep_dream.py,1593,1593,18,18,1,5.0235,634,3186,5023500
keras-314-4c16931b/imdb_cnn_lstm.py,127,127,8,8,1,0.4324,587,254,432400
keras-315-6d5cdd7e/antirectifier.py,658,658,13,13,1,2.042,644,1316,2042000
keras-316-ca5a4e3d/conv_lstm.py,1483,1483,21,21,1,4.725,627,2966,4725000
keras-317-cf6ca32e/imdb_cnn.py,114,114,8,8,1,0.3771,604,228,377100
keras-318-3e6db0e9/imdb_bidirectional_lstm.py,81,81,8,8,1,0.2791,580,162,279100
keras-320-12a82512/variational_autoencoder.py,1810,1810,18,18,3,5.6729,638,3620,5672900
keras-322-c0d1709c/models.py,1776,1714,21,21,68,7.68,454,3490,7680000
keras-322-c0d1709c/test_sequential_model.py,5844,5472,20,20,374,23.583,479,11316,23583000
keras-323-12a83f88/image_ocr.py,5883,5883,22,22,1,18.2652,644,11766,18265200
keras-325-a546ad4a/autogen.py,4883,4841,21,21,70,22.4427,433,9724,22442700
keras-326-b38b1b9d/conv_filter_visualization.py,1772,1772,20,20,1,5.7088,620,3544,5708800
keras-327-58399c11/mnist_siamese.py,921,921,17,17,1,2.8577,644,1842,2857700
keras-328-c170b8e0/cifar10_resnet.py,458,458,12,12,1,1.4272,641,916,1427200
keras-329-39c301d1/cifar10_cnn_tfaugment2d.py,1634,1634,17,17,1,5.0497,647,3268,5049700
keras-331-539aff8b/conv_filter_visualization.py,1772,1088,20,15,1034,10.8233,264,2860,10823300
keras-332-e2aced27/cifar10_cnn_capsule.py,1687,1687,18,18,1,5.1821,651,3374,5182100
keras-333-8bc53bef/vis_utils.py,1307,1277,26,26,31,5.4637,472,2584,5463700
keras-334-74ccfc4d/cifar10_cnn.py,1027,1027,12,12,1,3.1506,651,2054,3150600
keras-335-c55ce21f/autogen.py,4841,4841,21,21,12,20.1489,480,9682,20148900
keras-335-c55ce21f/test_doc_auto_generation.py,337,197,12,12,144,1.726,309,534,1726000
keras-336-3fb9df96/babi_memnn.py,1885,1885,18,18,1,5.8419,645,3770,5841900
keras-337-7a4c2fcd/autogen.py,4841,4755,21,21,136,20.5194,467,9596,20519400
keras-338-fe35050a/backend_test.py,25288,24984,23,23,306,104.0096,483,50272,104009600
keras-338-fe35050a/cntk_backend.py,22604,22562,23,23,44,94.5566,477,45166,94556600
keras-339-6368af9a/applications_test.py,583,576,14,14,27,2.5964,446,1159,2596400
keras-340-a1397169/autogen.py,4755,4596,21,21,278,26.5368,352,9351,26536800
keras-341-e59570ae/callbacks.py,11228,11228,28,28,2,35.0335,640,22456,35033500
keras-341-e59570ae/core.py,5928,5928,21,21,2,19.2424,616,11856,19242400
keras-341-e59570ae/cudnn_recurrent.py,4776,4776,23,23,1,15.3579,621,9552,15357900
keras-341-e59570ae/data_utils.py,3934,3934,23,23,1,13.2768,592,7868,13276800
keras-341-e59570ae/embeddings.py,1019,1019,25,25,1,3.354,607,2038,3354000
keras-341-e59570ae/local.py,2792,2792,17,17,1,8.6471,645,5584,8647100
keras-341-e59570ae/noise.py,1147,1147,19,19,1,3.6076,635,2294,3607600
keras-341-e59570ae/optimizers.py,8518,8518,22,22,3,26.1852,650,17036,26185200
keras-341-e59570ae/sequential.py,1633,1633,20,20,1,5.0925,641,3266,5092500
keras-341-e59570ae/test_documentation.py,1914,1808,18,17,115,7.8663,473,3722,7866300
keras-341-e59570ae/wrappers.py,5687,5687,23,23,1,17.6762,643,11374,17676200
keras-342-aac5391c/initializers.py,2504,2504,19,19,1,7.8652,636,5008,7865200
keras-343-b577dd9c/autogen.py,4596,4582,21,21,15,19.3793,473,9178,19379300
keras-344-931540d4/autogen.py,4582,4575,21,21,37,24.995,366,9157,24995000
keras-345-f42d9e01/autogen.py,4575,4547,21,21,54,25.1445,362,9122,25144500
keras-346-3dbc940b/backend_test.py,24984,24989,23,23,107,106.6226,468,49973,106622600
keras-346-3dbc940b/cntk_backend.py,22562,22562,23,23,0,69.5505,648,45124,69550500
keras-346-3dbc940b/convolutional_test.py,10193,10188,20,20,11,42.4162,480,20381,42416200
keras-346-3dbc940b/numpy_backend.py,8771,8771,24,24,2,27.7937,631,17542,27793700
keras-346-3dbc940b/theano_backend.py,24112,24112,24,24,0,74.4505,647,48224,74450500
keras-346-3dbc940b/__init__.py,7,7,6,6,1,0.0276,507,14,27600
keras-347-7d25cdca/tensorflow_backend.py,24837,24823,22,22,162,103.5135,479,49660,103513500
keras-348-4aba316b/tensorflow_backend.py,24823,24799,22,22,32,105.2862,471,49622,105286200
keras-349-68dc181a/data_utils_test.py,4588,4583,16,16,11,19.4151,472,9171,19415100
keras-349-68dc181a/__init__.py,7,905,6,20,1073,3.9868,228,912,3986800
keras-350-59fd3ce3/training.py,9492,9492,28,28,1,29.227,649,18984,29227000
keras-353-ec419894/autogen.py,4547,4688,21,21,172,19.7662,467,9235,19766200
keras-357-c2dc4049/core.py,5928,5826,21,20,195,31.5135,372,11754,31513500
keras-357-c2dc4049/core_test.py,3540,3404,18,18,138,14.9062,465,6944,14906200
keras-358-86ce3cdd/addition_rnn.py,1635,1635,20,20,1,5.1355,636,3270,5135500
keras-358-86ce3cdd/autogen.py,4688,4312,21,21,383,19.2268,468,9000,19226800
keras-358-86ce3cdd/babi_rnn.py,1686,1686,18,18,1,5.192,649,3372,5192000
keras-359-e4e342f7/activations.py,697,697,20,20,1,2.2763,612,1394,2276300
keras-360-4185cbb5/structure.py,4,4,4,4,0,0.0165,484,8,16500
keras-361-b0bfd520/optimizers.py,8518,8516,22,22,3,35.4423,480,17034,35442300
keras-361-b0bfd520/optimizers_test.py,1935,1635,18,18,302,7.7281,461,3570,7728100
keras-362-a6c80421/layer_utils.py,138,138,16,16,0,0.5383,512,276,538300
keras-363-d78c982b/test_training.py,17939,17619,20,20,322,72.5508,490,35558,72550800
keras-363-d78c982b/training.py,9492,9474,28,28,51,40.0912,473,18966,40091200
keras-363-d78c982b/training_arrays.py,4201,4162,21,23,105,18.7752,445,8363,18775200
keras-363-d78c982b/training_generator.py,4240,4219,26,26,85,17.7092,477,8459,17709200
keras-363-d78c982b/training_utils.py,4530,4413,26,26,120,30.0893,297,8943,30089300
keras-364-87540a2a/network.py,10475,10380,30,30,138,43.1329,483,20855,43132900
keras-364-87540a2a/test_topology.py,10634,10299,18,18,337,43.0964,485,20933,43096400
keras-366-8c9de834/callbacks.py,11228,11220,28,28,14,47.3909,473,22448,47390900
keras-367-844c1b44/generic_utils.py,4128,4128,25,25,1,12.7246,648,8256,12724600
keras-367-844c1b44/network.py,10380,10380,30,30,1,31.1912,665,20760,31191200
keras-367-844c1b44/sequential.py,1633,1633,20,20,1,4.9395,661,3266,4939500
keras-367-844c1b44/training_generator.py,4219,4219,26,26,3,12.6743,665,8438,12674300
keras-367-844c1b44/variational_autoencoder.py,1810,1810,18,18,2,5.4028,670,3620,5402800
keras-367-844c1b44/variational_autoencoder_deconv.py,2094,2094,18,18,2,6.1631,679,4188,6163100
keras-368-48a8fa0e/test_training.py,17619,17367,20,20,254,70.9696,492,34986,70969600
keras-368-48a8fa0e/training_utils.py,4413,4318,26,26,97,18.1166,481,8731,18116600
keras-369-57a4fd61/backend_test.py,24989,24986,23,23,5,101.528,492,49975,101528000
keras-369-57a4fd61/test_topology.py,10299,10296,18,18,5,41.6731,494,20595,41673100
keras-370-3fa96cf3/conv_utils.py,1197,1191,26,26,12,4.9854,478,2388,4985400
keras-371-49c8a35d/image.py,1559,1559,16,16,1,4.6622,668,3118,4662200
keras-372-34bce5ba/tensorflow_backend.py,24799,24799,22,22,27,74.773,663,49598,74773000
keras-373-a96d8709/core.py,5826,5826,20,20,1,17.402,669,11652,17402000
keras-374-8bb7e572/numpy_backend.py,8771,8768,24,24,5,36.0083,487,17539,36008300
keras-374-8bb7e572/tensorflow_backend.py,24799,24799,22,22,1,75.7657,654,49598,75765700
keras-376-fd537c79/callbacks.py,11220,11220,28,28,1,35.1708,638,22440,35170800
keras-376-fd537c79/lstm_seq2seq.py,1698,1698,18,18,1,5.1234,662,3396,5123400
keras-377-5c934bd6/advanced_activations_test.py,665,666,13,14,128,3.441,386,1331,3441000
keras-377-5c934bd6/convolutional_test.py,10188,10148,20,21,108,49.1521,413,20336,49152100
keras-377-5c934bd6/core_test.py,3404,3427,18,18,104,14.1645,482,6831,14164500
keras-377-5c934bd6/embeddings_test.py,329,352,16,17,66,1.6598,410,681,1659800
keras-378-ae30f36f/test_callbacks.py,12031,11915,21,21,130,49.894,479,23946,49894000
keras-379-1336cdb1/backend_test.py,24986,24966,23,23,65,102.0254,489,49952,102025400
keras-379-1336cdb1/tensorflow_backend.py,24799,24794,22,22,5,101.3454,489,49593,101345400
keras-380-6096ded9/callbacks.py,11220,10376,28,28,1265,49.2283,438,21596,49228300
keras-380-6096ded9/test_callbacks.py,11915,10130,21,21,1793,48.2244,457,22045,48224400
keras-380-6096ded9/training.py,9474,9385,28,28,383,41.5197,454,18859,41519700
keras-380-6096ded9/training_arrays.py,4162,3506,23,23,928,22.0703,347,7668,22070300
keras-380-6096ded9/training_generator.py,4219,3607,26,26,808,20.1422,388,7826,20142200
keras-381-87a74687/initializers.py,2504,2689,19,24,221,11.4114,455,5193,11411400
keras-382-3821c77d/cntk_backend.py,22562,22686,23,23,191,93.5083,483,45248,93508300
keras-383-c60f8f7b/mnist.py,157,167,12,11,19,0.9406,344,324,940600
keras-383-c60f8f7b/test_multiprocessing.py,7033,7033,17,17,18,31.3937,448,14066,31393700
keras-387-0cd3b07e/autogen.py,4312,4312,21,21,20,17.7617,485,8624,17761700
keras-387-0cd3b07e/test_doc_auto_generation.py,197,160,12,12,49,0.8387,425,357,838700
keras-388-5a8c85f1/applications_test.py,576,637,14,14,76,2.6472,458,1213,2647200
keras-389-1d81a202/image_ocr.py,5883,5883,22,22,0,17.4721,673,11766,17472100
keras-389-1d81a202/optimizers.py,8516,8516,22,22,1,25.1297,677,17032,25129700
keras-390-5394c04a/initializers.py,2689,2691,24,22,329,11.3961,472,5380,11396100
keras-390-5394c04a/initializers_test.py,1632,1639,15,16,67,6.8884,474,3271,6888400
keras-390-5394c04a/recurrent.py,17164,16960,28,28,208,71.6862,476,34124,71686200
keras-393-88cf9707/babi_memnn.py,1885,1885,18,18,0,5.6192,670,3770,5619200
keras-393-88cf9707/babi_rnn.py,1686,1686,18,18,0,5.0015,674,3372,5001500
keras-393-88cf9707/test_training.py,17367,17367,20,20,2,52.0377,667,34734,52037700
keras-394-e11c48d9/reuters.py,776,794,16,16,26,3.3844,463,1570,3384400
keras-395-b847b460/data_utils.py,3934,3902,23,23,33,16.0732,487,7836,16073200
keras-395-b847b460/data_utils_test.py,4583,4191,16,16,409,19.7032,445,8774,19703200
keras-398-fca79866/image.py,1559,1559,16,16,1,4.6563,669,3118,4656300
keras-399-7b9c8727/image.py,1559,1559,16,16,1,4.5801,680,3118,4580100
keras-400-994c4bb3/convolutional.py,12038,12038,23,23,2,36.6609,656,24076,36660900
keras-401-8461b092/autogen.py,4312,5410,21,21,1368,33.487,290,9722,33487000
keras-403-a9cd4bfc/numpy_backend.py,8768,8766,24,24,4,35.4575,494,17534,35457500
keras-404-0cfa5c27/network.py,10380,10368,30,30,12,41.6831,497,20748,41683100
keras-404-0cfa5c27/saving.py,9308,8524,30,30,802,43.3707,411,17832,43370700
keras-404-0cfa5c27/test_model_saving.py,10468,9168,18,18,1443,65.0359,301,19636,65035900
keras-404-0cfa5c27/test_utils.py,2462,1197,20,16,1269,10.9224,334,3659,10922400
keras-406-8f41e41e/test_training.py,17367,17148,20,20,221,69.3436,497,34515,69343600
keras-406-8f41e41e/training_utils.py,4318,4266,26,26,108,19.1209,448,8584,19120900
keras-407-f199d00e/data_utils_test.py,4191,4181,16,16,45,18.0774,463,8372,18077400
keras-407-f199d00e/test_multiprocessing.py,7033,5451,17,17,1827,41.6373,299,12484,41637300
keras-408-29e740e0/test_training.py,17148,16924,20,20,576,85.1953,399,34072,85195300
keras-409-bfa87eb1/backend_test.py,24966,24765,23,23,203,101.5423,489,49731,101542300
keras-409-bfa87eb1/numpy_backend.py,8766,8734,24,24,34,36.7209,476,17500,36720900
keras-409-bfa87eb1/tensorflow_backend.py,24794,24794,22,22,1,75.9268,653,49588,75926800
keras-410-bf0f25f7/autogen.py,5410,5491,21,21,94,22.2165,490,10901,22216500
keras-411-ca802e1b/backend_test.py,24765,24749,23,23,19,101.6849,486,49514,101684900
keras-411-ca802e1b/numpy_backend.py,8734,8703,24,24,33,38.5203,452,17437,38520300
keras-411-ca802e1b/tensorflow_backend.py,24794,24794,22,22,1,74.7068,663,49588,74706800
keras-412-4b54657a/data_utils.py,3902,3771,23,23,162,16.8586,455,7673,16858600
keras-412-4b54657a/data_utils_test.py,4181,3800,16,16,459,25.5678,312,7981,25567800
keras-412-4b54657a/interface_test.py,11081,11026,14,14,63,61.1904,361,22107,61190400
keras-412-4b54657a/test_training.py,16924,16913,20,20,16,71.5488,472,33837,71548800
keras-413-88af7d0c/test_loss_masking.py,570,468,14,14,143,2.8463,364,1038,2846300
keras-413-88af7d0c/training_utils.py,4266,4255,26,26,12,17.6592,482,8521,17659200
keras-415-4449be11/network.py,10368,10395,30,30,35,42.2309,491,20763,42230900
keras-416-e90e1706/recurrent.py,16960,16960,28,28,2,51.4158,659,33920,51415800
keras-417-c05ef1fd/backend_test.py,24749,24512,23,23,239,100.679,489,49261,100679000
keras-417-c05ef1fd/numpy_backend.py,8703,8616,24,24,89,35.2682,491,17319,35268200
keras-417-c05ef1fd/tensorflow_backend.py,24794,24794,22,22,1,75.0221,660,49588,75022100
keras-418-26b620fb/scikit_learn.py,1865,1862,19,19,3,7.7082,483,3727,7708200
keras-418-26b620fb/scikit_learn_test.py,1792,1646,14,14,148,7.0053,490,3438,7005300
keras-420-7cd6c597/backend_test.py,24512,24504,23,23,10,99.3024,493,49016,99302400
keras-420-7cd6c597/tensorflow_backend.py,24794,25359,22,22,849,106.7404,469,50153,106740400
keras-421-00a27e25/setup.py,112,111,11,11,1,0.6342,351,223,634200
keras-421-00a27e25/test_doc_auto_generation.py,160,143,12,11,35,0.8279,365,303,827900
keras-422-13b255df/babi_rnn.py,1686,1686,18,18,0,5.2102,647,3372,5210200
keras-423-a8e235c3/babi_rnn.py,1686,1769,18,18,122,8.4462,409,3455,8446200
keras-427-43b5e999/data_utils_test.py,3800,3804,16,16,6,18.2612,416,7604,18261200
keras-427-43b5e999/metrics_test.py,2736,2738,18,18,3,11.1052,492,5474,11105200
keras-427-43b5e999/test_training.py,16913,16915,20,20,3,68.1299,496,33828,68129900
keras-428-8a73aec6/normalization.py,1732,1681,20,20,53,7.0087,486,3413,7008700
keras-428-8a73aec6/tensorflow_backend.py,25359,25065,22,22,300,112.1223,449,50424,112122300
keras-429-1c221934/activations.py,697,697,20,20,1,2.125,656,1394,2125000
keras-430-cd44c6e0/backend_test.py,24504,24942,23,23,1863,109.11,453,49446,109110000
keras-430-cd44c6e0/numpy_backend.py,8616,8500,24,24,465,36.5265,468,17116,36526500
keras-430-cd44c6e0/tensorflow_backend.py,25065,25081,22,22,21,101.9366,491,50146,101936600
keras-431-920e8af3/conftest.py,6,6,6,6,1,0.0249,481,12,24900
keras-432-edd0c0a4/data_utils_test.py,3804,3731,16,16,91,20.8932,360,7535,20893200
keras-432-edd0c0a4/metrics_test.py,2738,2699,18,18,49,13.0757,415,5437,13075700
keras-432-edd0c0a4/setup.py,111,110,11,11,4,0.6099,362,221,609900
keras-432-edd0c0a4/test_training.py,16915,16876,20,20,45,70.3731,480,33791,70373100
keras-433-d2ebf181/backend_test.py,24942,24714,23,23,230,100.9926,491,49656,100992600
keras-433-d2ebf181/tensorflow_backend.py,25081,24151,22,22,955,103.4775,475,49232,103477500
keras-435-2b831d5b/text.py,79,68,6,6,11,0.3493,420,147,349300
keras-436-9eaa40b2/data_utils.py,3771,3771,23,23,1,11.6842,645,7542,11684200
keras-437-dcb5e3cf/autogen.py,5491,5485,21,21,18,23.5838,465,10976,23583800
keras-438-5e126ec9/mnist_acgan.py,3024,3033,22,22,11,13.0474,464,6057,13047400
keras-440-dc9e5101/constraints_test.py,976,964,17,17,20,4.1928,462,1940,4192800
keras-442-75a35032/saving.py,8524,8513,30,30,13,35.2331,483,17037,35233100
keras-443-63543a7e/tensorflow_backend.py,24151,24151,22,22,1,72.6372,664,48302,72637200
keras-444-8b59e31d/callbacks.py,10376,10376,28,28,1,31.2165,664,20752,31216500
keras-445-a0e90bd8/data_utils_test.py,3731,3728,16,16,7,15.4893,481,7459,15489300
keras-445-a0e90bd8/test_multiprocessing.py,5451,5448,17,17,7,22.3558,487,10899,22355800
keras-447-64737f23/tensorflow_backend.py,24151,24151,22,22,10,73.2387,659,48302,73238700
keras-449-09d721ab/neural_style_transfer.py,2379,2379,17,17,0,7.1359,666,4758,7135900
keras-450-5a8f346e/numpy_backend.py,8500,8484,24,24,43,35.7412,475,16984,35741200
keras-450-5a8f346e/tensorflow_backend.py,24151,24151,22,22,1,72.766,663,48302,72766000
keras-451-140605ee/backend_test.py,24714,23516,23,23,1200,99.3555,485,48230,99355500
keras-451-140605ee/cntk_backend.py,22686,22654,23,23,34,92.7578,488,45340,92757800
keras-451-140605ee/convolutional_recurrent_test.py,1481,1373,20,18,130,6.8173,418,2854,6817300
keras-451-140605ee/recurrent_test.py,9920,8665,18,18,1257,38.0101,488,18585,38010100
keras-451-140605ee/tensorflow_backend.py,24151,24118,22,24,462,103.389,466,48269,103389000
keras-451-140605ee/theano_backend.py,24112,23938,24,24,252,100.7905,476,48050,100790500
keras-452-62254017/test_utils.py,1197,1225,16,16,38,5.9394,407,2422,5939400
keras-453-351e7a99/backend_test.py,23516,23305,23,23,360,97.7597,478,46821,97759700
keras-454-314c4495/training.py,9385,9379,28,28,10,38.4979,487,18764,38497900
keras-457-7c90c378/tensorflow_backend.py,24118,24118,24,24,10,73.7562,653,48236,73756200
keras-458-58432f2c/training_utils.py,4255,4255,26,26,1,12.8951,659,8510,12895100
keras-459-1d10fe2d/setup.py,110,111,11,11,3,0.5463,404,221,546300
keras-460-08a6dd04/test_utils.py,1225,1279,16,16,65,5.2677,475,2504,5267700
keras-461-6207edd1/numpy_backend.py,8484,8509,24,24,61,34.8355,487,16993,34835500
keras-461-6207edd1/tensorflow_backend.py,24118,24118,24,24,1,72.9112,661,48236,72911200
keras-462-97bff7df/backend_test.py,23305,23352,23,23,74,94.8736,491,46657,94873600
keras-463-384d3bc3/numpy_backend.py,8509,8523,24,24,58,34.9788,486,17032,34978800
keras-464-b9f3b4a6/backend_test.py,23352,26047,23,23,3442,124.051,398,49399,124051000
keras-466-9e410e78/deep_dream.py,1593,1593,18,18,31,6.6737,477,3186,6673700
keras-467-8ef5dcfd/generic_utils.py,4128,4111,25,25,19,16.7084,493,8239,16708400
keras-468-e47a003e/autogen.py,5485,5222,21,21,288,31.8972,335,10707,31897200
keras-468-e47a003e/backend_test.py,26047,26046,23,23,6,105.9867,491,52093,105986700
keras-468-e47a003e/tensorflow_backend.py,24118,24118,24,24,3,73.1008,659,48236,73100800
keras-469-b7fad075/core.py,5826,5826,20,20,1,17.7334,657,11652,17733400
keras-470-3e772def/backend_test.py,26046,26118,23,23,164,106.4302,490,52164,106430200
keras-470-3e772def/reference_operations.py,8523,8059,24,24,466,34.0694,486,16582,34069400
keras-471-2898da6c/saving.py,8513,8511,30,30,34,34.5811,492,17024,34581100
keras-472-48c1c96a/autogen.py,5222,5221,21,21,1,21.453,486,10443,21453000
keras-473-a37b41d5/tensorflow_backend.py,24118,24006,24,27,259,112.8299,426,48124,112829900
keras-474-aa0f12ce/autogen.py,5221,5112,21,21,131,21.6462,477,10333,21646200
keras-474-aa0f12ce/test_doc_auto_generation.py,143,93,11,11,52,0.6025,391,236,602500
keras-475-267ccbb4/autogen.py,5112,5117,21,21,21,20.9478,488,10229,20947800
keras-476-df818683/backend_test.py,26118,26112,23,23,14,107.12,487,52230,107120000
keras-476-df818683/reference_operations.py,8059,8028,24,24,35,52.0098,309,16087,52009800
keras-477-74264ea3/io_utils.py,3119,3060,23,23,71,12.7017,486,6179,12701700
keras-477-74264ea3/io_utils_test.py,2066,1919,15,15,153,12.8366,310,3985,12836600
keras-478-9148325b/autogen.py,5117,5112,21,21,20,20.8058,491,10229,20805800
keras-478-9148325b/generic_utils.py,4111,3998,25,25,115,16.7194,485,8109,16719400
keras-478-9148325b/image.py,1559,1558,16,16,13,6.4104,486,3117,6410400
keras-479-33487127/backend_test.py,26112,25693,23,23,661,107.9307,479,51805,107930700
keras-479-33487127/cntk_backend.py,22654,21921,23,23,1116,109.0045,408,44575,109004500
keras-479-33487127/reference_operations.py,8028,8049,24,24,442,35.0064,459,16077,35006400
keras-479-33487127/tensorflow_backend.py,24006,23691,27,27,742,101.2769,470,47697,101276900
keras-479-33487127/theano_backend.py,23938,23973,24,24,75,98.1939,487,47911,98193900
keras-480-882302d2/callbacks.py,10376,10360,28,28,18,42.2409,490,20736,42240900
keras-480-882302d2/test_callbacks.py,10130,10124,21,21,9,40.8887,495,20254,40888700
keras-481-dbf80623/vis_utils.py,1277,902,26,21,421,5.5688,391,2179,5568800
keras-481-dbf80623/vis_utils_test.py,625,392,13,13,247,2.4058,422,1017,2405800
keras-483-d6b5c5eb/data_utils_test.py,3728,3713,16,16,62,17.7134,420,7441,17713400
keras-484-36b9e4c0/data_utils.py,3771,3763,23,23,10,15.6104,482,7534,15610400
keras-484-36b9e4c0/data_utils_test.py,3713,3699,16,16,16,15.0922,491,7412,15092200
keras-484-36b9e4c0/test_image_data_tasks.py,755,397,15,15,370,3.3176,347,1152,3317600
keras-484-36b9e4c0/test_multiprocessing.py,5448,5434,17,17,16,22.2318,489,10882,22231800
keras-484-36b9e4c0/training_generator.py,3607,3621,26,26,198,16.1752,446,7228,16175200
keras-484-36b9e4c0/training_utils.py,4255,4176,26,26,83,28.2443,298,8431,28244300
keras-485-b9a74813/autogen.py,5112,5095,21,21,33,21.1169,483,10207,21116900
keras-486-0a639230/convolutional.py,12038,12038,23,23,5,36.4093,661,24076,36409300
keras-487-c2244d2a/backend_test.py,25693,25555,23,23,138,103.7424,493,51248,103742400
keras-487-c2244d2a/cntk_backend.py,21921,21892,23,23,50,90.2121,485,43813,90212100
keras-487-c2244d2a/tensorflow_backend.py,23691,23682,27,27,64,97.8379,484,47373,97837900
keras-487-c2244d2a/theano_backend.py,23973,23918,24,24,68,97.9881,488,47891,97988100
keras-488-37c0c1e1/backend_test.py,25555,25563,23,23,167,107.0401,477,51118,107040100
keras-489-5ef0fc32/vis_utils.py,902,876,21,21,29,3.7137,478,1778,3713700
keras-489-5ef0fc32/vis_utils_test.py,392,306,13,13,97,2.0165,346,698,2016500
keras-490-8fc8a168/cntk_backend.py,21892,21798,23,23,153,110.0185,397,43690,110018500
keras-491-2fdbaa10/theano_backend.py,23918,23782,24,24,402,129.003,369,47700,129003000
keras-492-dc6f00fa/backend_test.py,25563,25563,23,23,2,76.141,671,51126,76141000
keras-492-dc6f00fa/reference_operations.py,8049,7926,24,24,125,32.6155,489,15975,32615500
keras-493-e15533e6/backend_test.py,25563,25500,23,23,117,116.2271,439,51063,116227100
keras-494-7d5d4a63/backend_test.py,25500,25500,23,23,4,76.2852,668,51000,76285200
keras-494-7d5d4a63/reference_operations.py,7926,7659,24,24,271,45.7935,340,15585,45793500
keras-495-885ba629/backend_test.py,25500,25480,23,23,39,104.2156,489,50980,104215600
keras-495-885ba629/reference_operations.py,7659,7591,24,24,70,30.9569,492,15250,30956900
keras-496-2f12e96d/backend_test.py,25480,25480,23,23,8,77.3115,659,50960,77311500
keras-497-f93a2256/backend_test.py,25480,25480,23,23,2,76.3055,667,50960,76305500
keras-497-f93a2256/reference_operations.py,7591,7568,24,24,25,30.7623,492,15159,30762300
keras-499-f2b261bc/common.py,431,431,14,14,1,1.3446,641,862,1344600
